yr,mnth,hr,temp,atemp,windspeed,casual,registered,cnt
0,5,5,0.56,0.5303,0.2239,4,3,7
0,10,4,0.44,0.4394,0.0,1,4,5
1,10,19,0.44,0.4394,0.1343,81,662,743
1,2,11,0.26,0.2273,0.3582,45,163,208
1,6,21,0.66,0.6212,0.1045,83,250,333
0,3,18,0.34,0.303,0.2985,15,172,187
1,10,17,0.3,0.2879,0.2239,19,105,124
1,9,17,0.7,0.6364,0.2985,114,811,925
1,10,10,0.5,0.4848,0.0,51,161,212
0,2,19,0.34,0.3182,0.2239,18,143,161
1,8,11,0.72,0.6515,0.0,67,186,253
0,12,15,0.32,0.303,0.2836,23,184,207
1,4,1,0.44,0.4394,0.2239,14,50,64
0,5,18,0.58,0.5455,0.0,63,205,268
0,10,22,0.62,0.5758,0.19399999999999998,13,101,114
1,3,14,0.46,0.4545,0.2836,212,289,501
0,11,17,0.42,0.4242,0.3582,42,438,480
1,9,11,0.6,0.6212,0.2239,222,369,591
0,6,9,0.62,0.5606,0.2537,32,243,275
1,8,12,0.8,0.7424,0.1045,75,209,284
0,2,6,0.2,0.2121,0.1343,2,3,5
1,8,21,0.72,0.6818,0.1343,32,275,307
1,9,2,0.6,0.5152,0.19399999999999998,0,4,4
1,10,4,0.5,0.4848,0.0896,1,5,6
1,3,16,0.62,0.6061,0.2239,99,332,431
0,1,22,0.16,0.1212,0.4478,1,32,33
1,6,18,0.8,0.7576,0.19399999999999998,62,443,505
1,6,13,0.6,0.6212,0.1642,66,201,267
1,5,13,0.64,0.6061,0.0,48,195,243
1,5,10,0.5,0.4848,0.4179,42,112,154
0,2,6,0.16,0.2273,0.0,2,26,28
0,10,22,0.36,0.3636,0.0896,9,55,64
1,12,1,0.28,0.2727,0.2239,3,18,21
1,2,15,0.44,0.4394,0.19399999999999998,13,133,146
0,12,9,0.26,0.2424,0.2537,5,95,100
1,5,7,0.48,0.4697,0.1045,18,367,385
0,7,8,0.76,0.7424,0.0,34,353,387
0,11,5,0.32,0.3333,0.1343,1,27,28
0,6,8,0.56,0.5303,0.3284,31,471,502
1,7,7,0.7,0.6667,0.1343,17,404,421
0,4,17,0.38,0.3939,0.3582,89,95,184
1,2,19,0.36,0.3333,0.2985,5,299,304
1,2,12,0.3,0.3182,0.0896,40,260,300
1,12,0,0.5,0.4848,0.2836,6,31,37
1,7,2,0.66,0.6212,0.0896,0,9,9
1,5,4,0.56,0.5303,0.1642,0,7,7
1,6,2,0.54,0.5152,0.2239,3,6,9
1,8,0,0.7,0.6667,0.0,8,55,63
1,3,10,0.46,0.4545,0.4478,42,124,166
0,2,10,0.2,0.2121,0.1343,3,31,34
0,10,2,0.3,0.2727,0.2985,1,16,17
0,12,11,0.4,0.4091,0.4179,9,126,135
1,10,13,0.42,0.4242,0.2239,22,191,213
0,8,3,0.7,0.6667,0.1343,9,23,32
0,10,9,0.42,0.4242,0.0896,47,122,169
0,11,17,0.54,0.5152,0.19399999999999998,37,167,204
0,2,2,0.14,0.1667,0.1045,0,1,1
1,5,20,0.62,0.5758,0.0896,28,267,295
0,12,23,0.38,0.3939,0.0,13,40,53
1,7,5,0.66,0.6212,0.0,5,14,19
0,11,7,0.24,0.2273,0.2537,3,38,41
0,10,2,0.38,0.3939,0.1642,6,12,18
0,5,11,0.56,0.5303,0.4179,26,104,130
1,11,23,0.34,0.303,0.2985,11,108,119
1,8,0,0.66,0.6212,0.0,13,63,76
0,12,23,0.24,0.2576,0.0,1,16,17
0,11,2,0.44,0.4394,0.19399999999999998,1,2,3
1,11,14,0.58,0.5455,0.2836,134,310,444
0,5,1,0.7,0.6515,0.2985,14,36,50
0,10,6,0.32,0.3182,0.1642,2,13,15
0,6,5,0.72,0.6970000000000001,0.1642,2,22,24
1,4,5,0.4,0.4091,0.4925,2,22,24
1,6,20,0.86,0.7727,0.2239,81,326,407
1,2,20,0.42,0.4242,0.1642,2,95,97
0,6,10,0.72,0.6515,0.19399999999999998,35,97,132
1,11,2,0.32,0.3333,0.1045,12,58,70
0,6,22,0.62,0.6212,0.0,26,145,171
1,7,9,0.66,0.6212,0.19399999999999998,82,200,282
0,5,4,0.52,0.5,0.0,5,8,13
0,4,15,0.34,0.3333,0.19399999999999998,13,62,75
0,5,15,0.6,0.6212,0.19399999999999998,74,168,242
0,1,18,0.2,0.1818,0.3284,3,141,144
0,9,21,0.52,0.5,0.19399999999999998,27,179,206
0,1,8,0.22,0.2121,0.2985,3,69,72
1,11,14,0.42,0.4242,0.0,51,177,228
0,1,6,0.12,0.1515,0.1045,0,36,36
1,10,14,0.7,0.6515,0.2537,56,211,267
1,4,14,0.48,0.4697,0.3881,240,250,490
1,4,19,0.56,0.5303,0.1343,128,247,375
1,9,5,0.66,0.5909,0.0,2,10,12
1,5,14,0.74,0.6818,0.2239,72,180,252
1,3,10,0.52,0.5,0.19399999999999998,148,197,345
0,11,15,0.34,0.303,0.4478,10,106,116
0,11,16,0.44,0.4394,0.0,3,59,62
1,8,2,0.7,0.6667,0.1642,6,14,20
1,6,11,0.76,0.6818,0.1343,215,291,506
0,6,0,0.68,0.6364,0.1642,19,97,116
0,12,15,0.4,0.4091,0.2239,10,144,154
0,1,11,0.06,0.0758,0.1343,4,59,63
0,4,23,0.4,0.4091,0.1045,13,86,99
0,8,2,0.64,0.5758,0.0,0,8,8
1,12,13,0.38,0.3939,0.2836,65,220,285
0,9,21,0.62,0.5455,0.0896,24,113,137
1,8,11,0.82,0.7727,0.1045,59,167,226
0,9,23,0.62,0.5455,0.0,14,99,113
0,11,21,0.4,0.4091,0.0,9,152,161
0,4,17,0.34,0.303,0.3284,36,245,281
0,12,16,0.3,0.303,0.1642,22,155,177
1,7,14,0.78,0.6818,0.2239,42,167,209
0,5,6,0.64,0.5606,0.0896,6,10,16
1,10,2,0.34,0.3333,0.19399999999999998,7,60,67
0,7,9,0.78,0.7273,0.4925,27,149,176
0,8,15,0.78,0.6970000000000001,0.3582,155,314,469
1,5,4,0.58,0.5455,0.19399999999999998,0,3,3
1,4,3,0.32,0.3333,0.0896,0,3,3
0,1,5,0.22,0.2727,0.0,0,5,5
0,12,9,0.22,0.2273,0.1642,6,75,81
1,1,8,0.02,0.0606,0.1343,5,310,315
1,7,1,0.74,0.6970000000000001,0.0896,6,19,25
0,12,18,0.34,0.3182,0.2239,12,370,382
1,3,4,0.5,0.4848,0.1343,0,4,4
1,2,19,0.36,0.3333,0.2537,7,284,291
0,9,23,0.62,0.5455,0.1045,12,67,79
0,2,7,0.24,0.2424,0.1642,0,8,8
1,7,5,0.72,0.6667,0.0,3,37,40
0,11,11,0.42,0.4242,0.1045,28,100,128
0,5,10,0.8,0.7576,0.2537,116,153,269
0,5,5,0.42,0.4242,0.1343,2,27,29
0,11,8,0.42,0.4242,0.0,13,394,407
1,10,6,0.42,0.4242,0.0,5,26,31
0,5,22,0.6,0.5758,0.1343,25,116,141
1,5,10,0.62,0.5909,0.1045,27,144,171
1,10,9,0.48,0.4697,0.2836,62,161,223
1,8,8,0.66,0.6212,0.1642,28,780,808
1,6,7,0.6,0.6212,0.3582,29,498,527
1,10,18,0.66,0.6212,0.0,63,795,858
0,11,22,0.5,0.4848,0.19399999999999998,6,81,87
0,7,19,0.74,0.6970000000000001,0.2239,71,323,394
0,11,16,0.44,0.4394,0.2239,13,95,108
1,6,4,0.62,0.5455,0.0,3,15,18
0,1,22,0.12,0.1061,0.3881,1,33,34
1,9,12,0.66,0.6212,0.0,247,510,757
0,10,14,0.44,0.4394,0.2239,22,119,141
0,8,16,0.72,0.6970000000000001,0.1642,97,161,258
1,7,2,0.7,0.6667,0.1343,1,15,16
1,8,10,0.7,0.6515,0.2985,148,294,442
1,4,9,0.3,0.2727,0.3881,17,255,272
0,3,5,0.24,0.2424,0.1343,0,8,8
1,2,21,0.3,0.303,0.1642,8,90,98
0,4,2,0.42,0.4242,0.1045,14,2,16
0,2,20,0.2,0.19699999999999998,0.2239,3,102,105
1,4,16,0.38,0.3939,0.4478,4,32,36
1,6,15,0.9,0.8182,0.0,36,143,179
0,10,18,0.6,0.6212,0.1642,57,536,593
0,8,1,0.68,0.6364,0.0896,13,64,77
0,7,8,0.7,0.6667,0.1045,42,44,86
0,1,6,0.14,0.1061,0.3881,0,30,30
0,2,0,0.24,0.2879,0.0,1,14,15
1,1,23,0.46,0.4545,0.3881,1,60,61
1,5,11,0.56,0.5303,0.2239,12,67,79
0,12,20,0.32,0.3333,0.0896,8,18,26
1,10,20,0.54,0.5152,0.0,11,251,262
1,6,18,0.64,0.6212,0.0,171,341,512
1,8,15,0.88,0.8182,0.2537,112,268,380
0,5,6,0.44,0.4394,0.2537,2,87,89
1,3,7,0.4,0.4091,0.19399999999999998,13,265,278
0,2,12,0.4,0.4091,0.0896,61,132,193
1,5,21,0.58,0.5455,0.1045,45,254,299
1,10,11,0.42,0.4242,0.1045,76,260,336
0,7,22,0.74,0.7121,0.0,36,120,156
0,9,1,0.68,0.6364,0.1045,19,35,54
0,2,15,0.28,0.2727,0.2537,9,81,90
1,3,11,0.44,0.4394,0.0,40,167,207
0,2,12,0.36,0.3182,0.4627,58,94,152
0,2,19,0.4,0.4091,0.1343,16,86,102
0,2,11,0.22,0.2273,0.1642,3,61,64
0,4,1,0.5,0.4848,0.19399999999999998,14,40,54
1,10,23,0.66,0.6061,0.0,21,199,220
1,2,12,0.28,0.2727,0.2239,65,216,281
0,6,9,0.62,0.6061,0.19399999999999998,29,232,261
1,10,23,0.3,0.303,0.1343,3,36,39
1,8,9,0.68,0.6364,0.0,41,335,376
1,8,12,0.78,0.7121,0.1343,93,207,300
0,9,14,0.78,0.7121,0.2239,19,105,124
1,2,18,0.34,0.3182,0.2239,27,215,242
0,1,1,0.2,0.1667,0.4179,0,2,2
1,1,1,0.3,0.2879,0.2239,4,9,13
0,1,11,0.2,0.19699999999999998,0.2239,18,54,72
0,8,8,0.62,0.6061,0.1343,32,436,468
0,6,23,0.58,0.5455,0.1045,30,141,171
1,3,6,0.4,0.4091,0.2537,5,13,18
0,9,23,0.62,0.5455,0.19399999999999998,3,21,24
0,8,1,0.7,0.6667,0.1642,13,51,64
1,2,8,0.26,0.303,0.0,4,516,520
1,7,13,0.6,0.5606,0.1642,106,248,354
0,6,18,0.74,0.6818,0.0896,78,218,296
1,11,14,0.28,0.2576,0.3582,8,86,94
1,8,13,0.76,0.7121,0.3582,66,224,290
0,10,8,0.36,0.3485,0.1343,32,56,88
0,9,9,0.64,0.5909,0.2985,39,168,207
1,3,20,0.46,0.4545,0.2985,34,301,335
1,11,22,0.3,0.2879,0.2537,4,56,60
1,5,6,0.46,0.4545,0.1045,8,134,142
1,3,4,0.18,0.1667,0.2985,0,3,3
0,5,18,0.58,0.5455,0.1642,114,175,289
1,7,19,0.68,0.6364,0.0,115,223,338
0,1,22,0.18,0.19699999999999998,0.1642,2,34,36
0,12,22,0.32,0.3333,0.0896,17,97,114
1,4,7,0.32,0.3333,0.0896,14,327,341
0,6,5,0.54,0.5152,0.0,1,12,13
0,4,4,0.24,0.2273,0.2537,0,3,3
0,10,5,0.34,0.3333,0.19399999999999998,0,31,31
0,8,21,0.68,0.6364,0.1343,7,81,88
1,7,5,0.66,0.5909,0.1343,2,40,42
0,4,22,0.48,0.4697,0.1045,22,82,104
1,5,9,0.62,0.6212,0.2537,129,184,313
0,3,5,0.36,0.3485,0.1343,0,3,3
1,6,20,0.68,0.6364,0.19399999999999998,36,350,386
1,5,17,0.74,0.6667,0.0896,83,756,839
0,6,21,0.72,0.6818,0.1045,58,125,183
0,1,15,0.26,0.2424,0.2537,14,58,72
0,7,16,0.72,0.6667,0.19399999999999998,96,265,361
0,11,4,0.2,0.2121,0.1343,0,7,7
1,12,4,0.26,0.303,0.0,1,6,7
1,5,7,0.54,0.5152,0.19399999999999998,14,344,358
1,11,17,0.42,0.4242,0.19399999999999998,33,586,619
1,12,12,0.22,0.19699999999999998,0.3284,0,10,10
1,7,7,0.72,0.6818,0.1343,18,58,76
1,10,9,0.52,0.5,0.0,26,314,340
0,4,0,0.52,0.5,0.2239,30,66,96
0,8,8,0.74,0.6667,0.19399999999999998,38,361,399
1,3,1,0.3,0.2879,0.2537,1,50,51
1,7,9,0.82,0.7273,0.1343,55,249,304
1,1,16,0.42,0.4242,0.3582,15,225,240
1,12,12,0.4,0.4091,0.0,21,211,232
0,7,15,0.84,0.8029999999999999,0.2985,194,182,376
1,11,21,0.32,0.3333,0.1045,20,204,224
1,8,7,0.6,0.5606,0.2239,12,52,64
0,9,21,0.64,0.5758,0.0896,4,34,38
1,12,14,0.4,0.4091,0.2836,164,378,542
0,5,1,0.52,0.5,0.1642,5,15,20
1,3,10,0.3,0.2727,0.3284,31,161,192
1,11,0,0.34,0.3485,0.0896,14,110,124
1,12,13,0.2,0.2424,0.0,13,71,84
0,2,22,0.28,0.2727,0.2239,8,38,46
1,4,20,0.56,0.5303,0.0896,22,358,380
1,6,16,0.76,0.6667,0.2985,111,412,523
0,3,17,0.5,0.4848,0.1045,42,265,307
1,3,2,0.46,0.4545,0.2836,0,6,6
0,11,11,0.56,0.5303,0.19399999999999998,18,116,134
0,12,16,0.46,0.4545,0.2537,4,84,88
0,5,3,0.58,0.5455,0.1045,0,2,2
1,5,18,0.64,0.6061,0.2836,69,641,710
1,11,6,0.24,0.2879,0.0,0,20,20
1,7,16,0.84,0.7727,0.0896,70,288,358
0,9,17,0.48,0.4697,0.4627,31,230,261
0,8,15,0.8,0.7727,0.19399999999999998,53,196,249
0,1,10,0.04,0.0606,0.1642,3,50,53
1,7,14,0.6,0.5455,0.2537,121,222,343
1,12,14,0.4,0.4091,0.0896,12,169,181
1,7,18,0.88,0.7727,0.3582,95,275,370
1,3,18,0.7,0.6364,0.1642,237,593,830
0,12,9,0.4,0.4091,0.2985,4,152,156
0,10,18,0.56,0.5303,0.1642,8,132,140
0,10,10,0.6,0.5909,0.1343,38,111,149
0,8,1,0.6,0.5909,0.0,2,13,15
1,6,10,0.88,0.7727,0.2537,96,308,404
0,11,7,0.26,0.2727,0.1045,4,24,28
1,6,12,0.66,0.6061,0.2537,19,76,95
1,5,4,0.62,0.5606,0.0,3,6,9
0,11,3,0.36,0.3485,0.1343,8,20,28
0,4,19,0.7,0.6364,0.4627,51,227,278
0,1,13,0.26,0.2727,0.1045,12,55,67
0,3,12,0.3,0.2727,0.3284,12,82,94
1,4,2,0.36,0.3636,0.1045,4,36,40
0,3,12,0.34,0.3333,0.1642,29,77,106
1,6,15,0.84,0.7121,0.2985,218,337,555
1,1,10,0.18,0.19699999999999998,0.1642,3,80,83
0,12,3,0.46,0.4545,0.2239,0,3,3
0,6,7,0.6,0.5606,0.0,25,225,250
1,10,20,0.5,0.4848,0.1343,54,360,414
0,2,2,0.18,0.1667,0.2537,0,2,2
0,1,21,0.06,0.1061,0.0896,0,39,39
0,1,16,0.22,0.2727,0.0,10,70,80
0,11,14,0.4,0.4091,0.19399999999999998,1,35,36
1,3,13,0.42,0.4242,0.1642,110,257,367
1,9,2,0.58,0.5455,0.1045,18,75,93
1,3,9,0.34,0.2879,0.5224,17,267,284
1,9,1,0.52,0.5,0.0,11,38,49
0,11,17,0.5,0.4848,0.19399999999999998,29,422,451
1,1,3,0.02,0.0152,0.2836,0,1,1
0,1,0,0.16,0.1364,0.2836,3,6,9
1,9,7,0.46,0.4545,0.1343,17,513,530
1,8,20,0.7,0.6667,0.1045,53,140,193
1,12,13,0.38,0.3939,0.2239,28,226,254
1,3,15,0.46,0.4545,0.1045,19,88,107
1,11,3,0.22,0.2424,0.1045,0,4,4
0,10,23,0.58,0.5455,0.19399999999999998,2,45,47
0,10,9,0.4,0.4091,0.0896,12,141,153
1,12,11,0.32,0.303,0.19399999999999998,31,180,211
1,2,3,0.4,0.4091,0.3582,0,6,6
1,6,19,0.74,0.6515,0.2239,95,460,555
0,5,2,0.5,0.4848,0.0896,4,9,13
0,8,18,0.86,0.7576,0.19399999999999998,65,491,556
1,8,10,0.72,0.6667,0.1642,34,144,178
0,10,23,0.22,0.2273,0.19399999999999998,3,33,36
0,8,9,0.82,0.7424,0.0,27,139,166
1,1,7,0.1,0.1364,0.1045,5,28,33
1,5,14,0.56,0.5303,0.4179,61,186,247
1,11,11,0.36,0.3485,0.2239,13,150,163
0,5,12,0.66,0.6212,0.0896,72,137,209
0,9,15,0.68,0.6364,0.3881,42,185,227
1,12,22,0.24,0.2576,0.0896,13,49,62
0,10,1,0.58,0.5455,0.1343,8,16,24
1,2,23,0.12,0.0758,0.4925,0,20,20
0,4,0,0.46,0.4545,0.0896,15,24,39
1,8,20,0.74,0.6818,0.2239,58,374,432
1,3,15,0.56,0.5303,0.0,68,175,243
0,3,2,0.26,0.2879,0.0896,0,1,1
0,9,11,0.66,0.6061,0.1045,24,127,151
0,6,18,0.64,0.5758,0.2239,26,299,325
0,4,14,0.5,0.4848,0.4179,35,80,115
1,1,18,0.16,0.1818,0.1045,11,110,121
0,2,6,0.2,0.2576,0.0,0,4,4
0,2,2,0.28,0.2273,0.6866,1,2,3
1,9,9,0.6,0.6212,0.2985,40,321,361
1,3,21,0.4,0.4091,0.3284,36,107,143
0,5,4,0.48,0.4697,0.1343,0,2,2
0,6,21,0.8,0.8029999999999999,0.1343,34,168,202
1,5,2,0.64,0.5758,0.1343,9,55,64
1,2,22,0.32,0.2879,0.4179,3,106,109
0,12,16,0.44,0.4394,0.3284,2,44,46
1,8,4,0.62,0.6061,0.1642,4,22,26
1,9,19,0.62,0.6212,0.2985,71,562,633
0,5,23,0.52,0.5,0.1343,9,72,81
1,6,20,0.8,0.7576,0.2537,59,399,458
1,7,0,0.66,0.5909,0.0896,11,36,47
0,11,12,0.4,0.4091,0.0896,3,18,21
1,7,8,0.7,0.6364,0.2537,43,745,788
1,4,20,0.56,0.5303,0.4179,65,146,211
0,10,11,0.56,0.5303,0.0,35,131,166
0,2,5,0.06,0.1061,0.1045,0,7,7
0,1,15,0.24,0.2121,0.2985,5,55,60
1,10,21,0.42,0.4242,0.1343,24,236,260
0,3,11,0.32,0.303,0.2985,14,67,81
1,5,21,0.54,0.5152,0.2239,37,210,247
0,8,10,0.8,0.8029999999999999,0.1343,88,178,266
1,1,0,0.16,0.1515,0.2239,0,24,24
0,8,13,0.76,0.7121,0.19399999999999998,63,169,232
0,9,21,0.64,0.5758,0.1343,18,164,182
1,3,4,0.46,0.4545,0.19399999999999998,0,1,1
0,10,7,0.54,0.5152,0.3881,15,244,259
1,9,20,0.7,0.6515,0.2537,76,249,325
1,1,21,0.36,0.3333,0.3582,18,109,127
0,4,20,0.34,0.3182,0.2836,4,87,91
1,6,11,0.8,0.7273,0.3284,54,127,181
0,9,5,0.56,0.5303,0.1045,2,3,5
1,1,15,0.42,0.4242,0.1045,22,142,164
1,10,15,0.66,0.6212,0.4179,213,355,568
0,7,13,0.78,0.7576,0.2836,54,175,229
1,3,8,0.36,0.3788,0.0,2,46,48
0,12,6,0.3,0.3182,0.0896,1,89,90
0,10,6,0.46,0.4545,0.0896,4,105,109
1,7,20,0.76,0.6970000000000001,0.4925,80,296,376
0,10,13,0.54,0.5152,0.2836,20,86,106
0,12,18,0.28,0.2727,0.19399999999999998,15,123,138
0,12,17,0.42,0.4242,0.0,20,391,411
1,6,22,0.72,0.6515,0.0896,52,245,297
1,10,23,0.46,0.4545,0.1045,20,143,163
0,12,1,0.32,0.3485,0.0,2,10,12
0,5,11,0.4,0.4091,0.3284,3,69,72
1,8,10,0.76,0.6818,0.0,88,111,199
0,1,12,0.42,0.4242,0.2836,29,55,84
1,2,21,0.3,0.303,0.1343,8,75,83
0,9,5,0.62,0.5455,0.0896,0,24,24
0,1,7,0.16,0.1818,0.1045,1,4,5
0,8,13,0.7,0.6667,0.1045,7,30,37
0,2,12,0.32,0.3485,0.0,7,59,66
0,8,22,0.74,0.6515,0.0,17,122,139
1,7,12,0.84,0.7576,0.2239,157,330,487
0,11,18,0.36,0.3485,0.1642,10,263,273
1,4,13,0.74,0.6667,0.2985,79,184,263
1,1,12,0.1,0.1061,0.19399999999999998,9,75,84
0,9,4,0.68,0.6364,0.2836,3,5,8
1,9,3,0.66,0.5909,0.0896,1,9,10
1,6,7,0.52,0.5,0.0896,18,30,48
0,9,15,0.62,0.5909,0.1045,34,158,192
1,10,14,0.62,0.6061,0.19399999999999998,73,209,282
1,9,17,0.64,0.6061,0.2239,102,740,842
1,7,16,0.8,0.7121,0.19399999999999998,69,370,439
0,5,13,0.58,0.5455,0.3284,71,182,253
0,11,22,0.34,0.303,0.3284,6,109,115
1,9,20,0.6,0.5455,0.19399999999999998,19,271,290
0,2,15,0.3,0.2727,0.4478,11,76,87
0,2,17,0.66,0.6212,0.3582,52,275,327
0,5,5,0.52,0.5,0.1343,0,14,14
1,9,7,0.5,0.4848,0.1045,28,43,71
0,7,17,0.76,0.6818,0.2239,234,241,475
1,1,19,0.32,0.303,0.2537,14,145,159
0,1,23,0.24,0.2121,0.2836,5,16,21
0,1,3,0.12,0.1212,0.2239,0,1,1
0,6,18,0.74,0.6515,0.3881,74,451,525
1,3,21,0.36,0.3485,0.1642,21,200,221
1,5,8,0.56,0.5303,0.1343,20,570,590
0,10,23,0.52,0.5,0.19399999999999998,7,63,70
0,12,13,0.3,0.3333,0.0,44,224,268
1,2,23,0.46,0.4545,0.2836,5,57,62
0,2,15,0.42,0.4242,0.2985,0,35,35
0,12,10,0.3,0.303,0.1642,3,99,102
1,4,11,0.44,0.4394,0.3284,47,186,233
0,12,11,0.34,0.303,0.2985,9,135,144
0,12,22,0.36,0.3636,0.1045,0,17,17
1,5,1,0.46,0.4545,0.1045,9,15,24
0,8,11,0.72,0.6667,0.2985,57,128,185
1,9,19,0.52,0.5,0.1642,82,331,413
0,5,17,0.64,0.6212,0.0,79,532,611
1,1,13,0.3,0.2727,0.4627,6,124,130
1,7,12,0.68,0.6364,0.1642,41,233,274
0,7,5,0.6,0.6061,0.1343,3,27,30
0,11,15,0.5,0.4848,0.1045,154,160,314
0,1,8,0.16,0.1667,0.1642,3,125,128
1,1,22,0.18,0.2121,0.0896,2,58,60
0,6,0,0.68,0.6364,0.2836,11,25,36
1,11,8,0.22,0.2576,0.0896,20,709,729
0,9,10,0.64,0.6061,0.1642,34,106,140
0,3,14,0.36,0.3333,0.3284,30,103,133
0,5,13,0.74,0.6818,0.1343,39,163,202
0,1,4,0.16,0.1818,0.1045,1,2,3
0,8,3,0.7,0.6515,0.1343,0,5,5
1,7,10,0.74,0.6970000000000001,0.2239,54,135,189
1,1,13,0.2,0.19699999999999998,0.2537,10,66,76
1,2,20,0.48,0.4697,0.3582,11,208,219
1,4,8,0.36,0.3636,0.0896,37,88,125
0,4,13,0.46,0.4545,0.4925,29,83,112
1,6,16,0.96,0.9091,0.0,59,292,351
0,3,15,0.34,0.3182,0.2537,43,79,122
1,11,17,0.56,0.5303,0.2836,66,530,596
1,2,15,0.42,0.4242,0.2537,229,270,499
1,10,1,0.52,0.5,0.0896,4,32,36
0,7,21,0.82,0.7576,0.1642,29,134,163
1,3,23,0.56,0.5303,0.1343,8,79,87
1,9,2,0.52,0.5,0.0,6,8,14
1,2,12,0.32,0.2727,0.6567,41,217,258
0,12,15,0.42,0.4242,0.0896,24,175,199
0,5,21,0.64,0.5909,0.0896,21,168,189
1,5,9,0.62,0.5909,0.1045,61,223,284
0,7,23,0.64,0.6061,0.2537,27,97,124
1,1,11,0.48,0.4697,0.1343,10,95,105
0,5,1,0.56,0.5303,0.0,7,6,13
0,11,8,0.34,0.303,0.2985,12,343,355
0,2,19,0.2,0.1818,0.2836,4,114,118
0,12,14,0.48,0.4697,0.2239,6,69,75
0,5,23,0.52,0.5,0.1642,15,100,115
1,6,7,0.5,0.4848,0.1045,6,29,35
0,8,23,0.6,0.5455,0.0896,18,88,106
0,8,2,0.68,0.6364,0.19399999999999998,13,51,64
1,6,21,0.64,0.6212,0.3582,79,317,396
1,10,1,0.46,0.4545,0.1343,2,93,95
0,2,21,0.4,0.4091,0.3582,6,45,51
0,1,19,0.16,0.19699999999999998,0.0896,3,92,95
0,10,20,0.34,0.3182,0.2239,12,131,143
0,5,22,0.66,0.5909,0.1343,78,93,171
0,9,7,0.6,0.5152,0.1642,8,177,185
1,3,14,0.44,0.4394,0.1642,123,291,414
1,8,10,0.74,0.6970000000000001,0.3881,127,258,385
0,3,15,0.5,0.4848,0.2239,55,79,134
1,2,16,0.46,0.4545,0.2836,18,211,229
1,6,16,0.72,0.6515,0.4925,72,320,392
1,1,12,0.18,0.1667,0.2985,42,192,234
1,12,3,0.26,0.2727,0.1343,3,7,10
1,5,23,0.48,0.4697,0.19399999999999998,8,47,55
1,1,13,0.2,0.1818,0.2836,40,184,224
0,11,4,0.3,0.3182,0.1045,4,3,7
0,9,20,0.46,0.4545,0.3284,25,223,248
1,1,2,0.16,0.1364,0.2836,5,38,43
0,11,21,0.38,0.3939,0.1045,10,129,139
1,9,6,0.54,0.5152,0.4179,6,27,33
0,6,3,0.66,0.6061,0.1343,14,16,30
1,2,13,0.4,0.4091,0.2836,23,159,182
0,8,10,0.7,0.6515,0.6119,27,115,142
1,2,16,0.36,0.3485,0.19399999999999998,5,206,211
0,11,13,0.48,0.4697,0.1642,22,139,161
0,1,12,0.2,0.1818,0.2836,5,47,52
1,7,22,0.68,0.6364,0.2537,33,224,257
0,10,13,0.5,0.4848,0.5821,28,136,164
1,11,4,0.26,0.2121,0.4478,1,2,3
1,8,19,0.76,0.7273,0.2239,119,567,686
1,9,16,0.7,0.6364,0.1343,99,437,536
1,4,2,0.5,0.4848,0.19399999999999998,1,8,9
1,10,1,0.42,0.4242,0.2836,16,96,112
1,12,2,0.2,0.2121,0.1642,1,17,18
0,3,13,0.46,0.4545,0.3582,22,83,105
0,1,16,0.2,0.1667,0.4478,13,79,92
0,7,1,0.7,0.6515,0.1343,19,94,113
1,1,3,0.24,0.2273,0.19399999999999998,0,4,4
1,5,10,0.58,0.5455,0.1045,28,147,175
0,9,17,0.68,0.6364,0.0,145,275,420
1,6,15,0.74,0.6515,0.2537,295,288,583
0,3,7,0.12,0.0909,0.4179,1,110,111
1,10,16,0.58,0.5455,0.1642,137,445,582
0,10,15,0.72,0.6515,0.1045,130,254,384
1,2,20,0.36,0.3182,0.5224,9,204,213
1,12,16,0.24,0.2273,0.2239,6,27,33
0,2,0,0.44,0.4394,0.2836,12,20,32
0,1,17,0.2,0.2576,0.0,9,178,187
1,3,2,0.46,0.4545,0.1045,15,41,56
1,12,15,0.38,0.3939,0.2239,20,250,270
1,6,18,0.8,0.6970000000000001,0.3284,85,719,804
1,11,16,0.42,0.4242,0.2836,33,350,383
1,9,5,0.44,0.4394,0.0,1,9,10
1,12,8,0.32,0.303,0.2836,8,464,472
0,7,20,0.7,0.6667,0.1642,61,281,342
0,5,23,0.7,0.6667,0.1045,14,34,48
0,1,14,0.28,0.303,0.0896,18,104,122
0,1,7,0.16,0.1818,0.1343,4,9,13
0,1,16,0.42,0.4242,0.2985,41,52,93
1,3,23,0.36,0.3333,0.2836,12,100,112
0,5,22,0.54,0.5152,0.1642,7,19,26
1,5,2,0.62,0.5455,0.0896,1,4,5
1,9,8,0.76,0.7121,0.2537,28,134,162
0,9,2,0.58,0.5455,0.0896,14,11,25
1,8,11,0.76,0.6818,0.0896,85,191,276
1,6,19,0.76,0.6970000000000001,0.5224,45,317,362
0,2,7,0.12,0.1212,0.2836,0,40,40
0,1,8,0.24,0.2879,0.0,1,7,8
1,12,12,0.36,0.3485,0.1642,31,181,212
0,11,4,0.4,0.4091,0.2836,2,10,12
0,5,9,0.58,0.5455,0.2537,36,98,134
0,8,2,0.7,0.6515,0.1045,2,6,8
1,2,19,0.3,0.2879,0.2537,18,101,119
1,10,14,0.54,0.5152,0.19399999999999998,43,201,244
1,3,13,0.58,0.5455,0.0896,83,215,298
1,6,4,0.64,0.5758,0.1642,6,13,19
1,1,17,0.26,0.2273,0.3284,21,364,385
1,5,2,0.46,0.4545,0.1343,4,13,17
0,10,12,0.52,0.5,0.1045,64,156,220
0,9,12,0.72,0.6818,0.19399999999999998,141,212,353
1,8,10,0.66,0.5909,0.1045,27,166,193
1,12,21,0.22,0.2121,0.2836,4,49,53
1,4,19,0.54,0.5152,0.1642,75,352,427
0,5,21,0.64,0.5758,0.2239,33,155,188
1,4,6,0.32,0.3182,0.1642,0,84,84
0,8,13,0.78,0.6818,0.0896,74,179,253
1,7,16,0.94,0.8788,0.3881,62,312,374
1,4,8,0.34,0.3636,0.0,27,577,604
1,2,20,0.36,0.3485,0.1642,4,207,211
1,2,21,0.34,0.303,0.4179,4,144,148
0,7,22,0.7,0.6667,0.19399999999999998,30,156,186
0,12,21,0.3,0.3182,0.0896,5,104,109
0,5,22,0.62,0.5455,0.2239,25,106,131
0,5,3,0.52,0.5,0.0,11,21,32
0,10,6,0.32,0.3333,0.1045,0,12,12
0,7,14,0.86,0.8182,0.19399999999999998,41,111,152
0,9,13,0.74,0.6667,0.2836,48,136,184
0,5,21,0.68,0.6364,0.1642,107,122,229
0,3,8,0.32,0.3182,0.19399999999999998,14,247,261
0,3,0,0.36,0.3485,0.2239,3,8,11
1,11,2,0.32,0.3182,0.1642,3,7,10
1,3,7,0.48,0.4697,0.19399999999999998,34,338,372
1,1,5,0.2,0.2121,0.1343,0,22,22
0,10,17,0.62,0.5758,0.2537,47,432,479
0,3,0,0.22,0.2273,0.19399999999999998,1,11,12
0,11,0,0.32,0.2879,0.3582,4,48,52
0,1,6,0.22,0.2121,0.2537,0,27,27
1,10,22,0.62,0.5455,0.1045,28,212,240
1,8,5,0.62,0.5758,0.0,1,36,37
0,1,8,0.16,0.1515,0.2239,3,30,33
1,12,23,0.42,0.4242,0.2239,6,41,47
0,7,15,0.94,0.9848,0.2985,32,101,133
0,12,17,0.44,0.4394,0.1642,24,332,356
0,3,8,0.22,0.2273,0.1343,24,42,66
1,9,9,0.6,0.6061,0.19399999999999998,27,307,334
0,10,20,0.52,0.5,0.19399999999999998,19,177,196
1,11,11,0.38,0.3939,0.19399999999999998,80,343,423
0,4,6,0.34,0.3636,0.0,2,33,35
1,5,0,0.58,0.5455,0.2537,10,26,36
1,4,5,0.5,0.4848,0.2537,0,1,1
1,4,15,0.62,0.6061,0.3582,260,226,486
0,2,12,0.2,0.2273,0.1045,7,48,55
1,3,14,0.56,0.5303,0.0,74,151,225
1,6,11,0.56,0.5303,0.19399999999999998,65,162,227
0,12,4,0.2,0.2576,0.0,0,4,4
0,4,23,0.54,0.5152,0.0896,5,37,42
0,8,5,0.66,0.6212,0.1343,4,17,21
1,5,20,0.66,0.6212,0.1642,36,299,335
0,1,14,0.2,0.19699999999999998,0.2239,0,47,47
1,3,17,0.46,0.4545,0.3881,68,498,566
0,1,10,0.2,0.2576,0.0,3,42,45
1,10,9,0.52,0.5,0.0896,24,349,373
0,1,9,0.22,0.2121,0.2985,3,55,58
1,2,9,0.3,0.303,0.1642,5,33,38
1,6,23,0.56,0.5303,0.1045,53,185,238
0,9,21,0.64,0.6061,0.0896,28,121,149
0,7,6,0.8,0.7879,0.0896,9,13,22
0,4,17,0.58,0.5455,0.2836,66,362,428
1,6,4,0.66,0.6061,0.2537,0,4,4
0,10,9,0.5,0.4848,0.0,54,163,217
0,11,23,0.46,0.4545,0.0896,3,25,28
0,5,15,0.72,0.6667,0.0,55,110,165
0,6,13,0.78,0.7424,0.2836,109,264,373
1,7,16,0.76,0.7121,0.2239,66,336,402
0,7,1,0.7,0.6667,0.2239,17,8,25
1,8,10,0.66,0.6212,0.1045,58,120,178
1,5,17,0.72,0.6667,0.0,69,716,785
1,10,16,0.54,0.5152,0.2836,79,367,446
1,11,11,0.36,0.3485,0.19399999999999998,14,156,170
0,5,19,0.46,0.4545,0.1045,47,131,178
0,9,6,0.38,0.3939,0.2239,6,87,93
1,2,23,0.32,0.303,0.2239,4,61,65
1,4,1,0.38,0.3939,0.2239,0,11,11
1,4,2,0.36,0.3485,0.1642,8,49,57
1,9,6,0.7,0.6667,0.0896,11,189,200
1,4,22,0.4,0.4091,0.4925,9,118,127
0,6,4,0.56,0.5303,0.2985,1,3,4
1,7,21,0.6,0.5455,0.1642,29,134,163
1,2,18,0.3,0.2576,0.5821,7,126,133
1,5,9,0.6,0.5606,0.1045,46,287,333
1,9,5,0.66,0.5909,0.2537,2,13,15
1,10,14,0.5,0.4848,0.4478,98,304,402
1,12,10,0.24,0.2273,0.19399999999999998,23,122,145
0,8,6,0.54,0.5152,0.19399999999999998,3,111,114
0,10,2,0.36,0.3636,0.1045,0,4,4
0,7,17,0.92,0.9091,0.2985,40,374,414
0,5,7,0.54,0.5152,0.2239,17,248,265
1,5,2,0.56,0.5303,0.0,36,62,98
0,6,2,0.62,0.5758,0.1642,1,5,6
1,10,8,0.44,0.4394,0.0,35,800,835
1,4,1,0.36,0.3485,0.1343,10,28,38
0,2,7,0.12,0.1515,0.1045,2,9,11
0,12,19,0.28,0.303,0.0896,9,232,241
0,4,3,0.36,0.3485,0.1642,5,9,14
0,8,17,0.78,0.7121,0.2985,84,466,550
1,8,7,0.74,0.7121,0.2985,18,50,68
0,12,10,0.48,0.4697,0.4179,6,83,89
1,8,1,0.7,0.6667,0.1343,5,23,28
1,2,19,0.34,0.3485,0.1045,11,256,267
1,7,11,0.84,0.7727,0.3284,67,184,251
1,11,7,0.3,0.303,0.1642,5,362,367
1,8,6,0.62,0.5909,0.0,12,175,187
1,10,2,0.56,0.5303,0.19399999999999998,13,62,75
1,9,15,0.72,0.6515,0.1045,99,253,352
0,12,17,0.34,0.3333,0.1343,11,33,44
0,12,18,0.38,0.3939,0.0,10,161,171
1,11,8,0.26,0.2121,0.4627,7,55,62
1,9,23,0.7,0.6667,0.2537,12,58,70
0,5,12,0.86,0.8029999999999999,0.1045,179,187,366
1,11,6,0.22,0.2727,0.0,1,123,124
0,7,16,0.68,0.6364,0.4478,27,105,132
0,1,15,0.22,0.2121,0.2537,22,98,120
0,7,2,0.64,0.6061,0.2239,28,66,94
1,6,18,0.82,0.6970000000000001,0.2239,175,276,451
0,8,13,0.78,0.7424,0.1045,72,165,237
1,1,10,0.24,0.2424,0.1343,38,153,191
1,5,2,0.5,0.4848,0.0896,1,7,8
0,8,17,0.72,0.7121,0.0,28,284,312
1,4,12,0.52,0.5,0.0,101,230,331
1,8,10,0.74,0.6970000000000001,0.2239,54,159,213
0,12,1,0.2,0.2576,0.0,0,9,9
0,1,12,0.12,0.1364,0.19399999999999998,11,52,63
0,1,21,0.26,0.2273,0.3284,11,20,31
0,10,13,0.54,0.5152,0.2239,60,138,198
0,7,1,0.64,0.6061,0.19399999999999998,16,86,102
1,9,4,0.5,0.4848,0.0,2,6,8
0,10,0,0.44,0.4394,0.1343,4,26,30
1,7,13,0.86,0.7879,0.2836,173,325,498
1,12,23,0.24,0.2879,0.0,1,10,11
0,11,22,0.42,0.4242,0.2537,30,88,118
1,10,11,0.42,0.4242,0.1343,192,335,527
0,6,3,0.64,0.5758,0.0896,2,1,3
1,4,7,0.3,0.2879,0.2836,15,231,246
1,12,2,0.24,0.2273,0.2537,0,5,5
0,8,7,0.64,0.5758,0.0,3,263,266
1,7,4,0.66,0.6061,0.0896,0,6,6
0,9,4,0.6,0.5455,0.19399999999999998,2,5,7
1,10,11,0.46,0.4545,0.0,76,175,251
1,3,0,0.3,0.2727,0.3582,9,68,77
1,2,13,0.36,0.3636,0.0,25,173,198
1,7,22,0.68,0.6364,0.19399999999999998,26,151,177
1,3,10,0.5,0.4848,0.0896,140,303,443
1,9,8,0.56,0.5303,0.0,33,725,758
1,2,8,0.26,0.2424,0.2836,16,543,559
0,9,9,0.62,0.5455,0.1642,5,131,136
0,12,19,0.24,0.2121,0.3284,11,95,106
1,3,11,0.58,0.5455,0.1343,74,156,230
1,8,10,0.8,0.7424,0.19399999999999998,82,167,249
1,8,8,0.74,0.7273,0.19399999999999998,49,132,181
0,8,18,0.76,0.6818,0.2985,89,376,465
0,3,0,0.6,0.6212,0.2537,26,50,76
1,7,14,0.94,0.8788,0.3284,54,116,170
1,8,4,0.64,0.6061,0.0,2,6,8
1,10,21,0.66,0.6212,0.0,14,195,209
0,9,13,0.6,0.6061,0.0,53,124,177
1,1,17,0.22,0.2121,0.2537,15,131,146
1,8,10,0.7,0.6667,0.1045,53,155,208
0,5,2,0.44,0.4394,0.0,6,2,8
0,3,1,0.22,0.2273,0.19399999999999998,0,4,4
0,2,12,0.3,0.3182,0.1045,62,120,182
0,11,9,0.3,0.3182,0.0896,36,134,170
0,2,21,0.38,0.3939,0.3881,2,78,80
1,8,18,0.8,0.7121,0.0,109,723,832
1,6,19,0.62,0.5606,0.3582,4,41,45
1,8,18,0.82,0.2424,0.2537,108,561,669
1,11,10,0.38,0.3939,0.2985,21,183,204
1,4,22,0.54,0.5152,0.1642,64,148,212
0,10,15,0.48,0.4697,0.4478,22,138,160
1,8,21,0.76,0.7273,0.2239,41,301,342
0,5,11,0.64,0.6212,0.1343,173,245,418
0,3,16,0.34,0.303,0.3582,26,96,122
0,11,10,0.52,0.5,0.0,25,110,135
1,5,5,0.46,0.4545,0.1045,1,33,34
1,8,15,0.88,0.7727,0.2239,63,204,267
1,10,6,0.52,0.5,0.19399999999999998,3,168,171
1,7,6,0.64,0.6061,0.0896,7,171,178
1,2,3,0.28,0.2879,0.1045,0,1,1
1,12,16,0.28,0.2424,0.4179,31,102,133
1,8,14,0.9,0.7727,0.2239,112,324,436
0,11,1,0.36,0.3485,0.19399999999999998,13,58,71
1,9,12,0.78,0.7727,0.1045,49,217,266
1,5,4,0.56,0.5303,0.2985,2,5,7
0,4,21,0.46,0.4545,0.19399999999999998,50,145,195
0,2,16,0.56,0.5303,0.2985,29,117,146
1,10,17,0.56,0.5303,0.2537,65,791,856
1,9,16,0.64,0.6212,0.2239,202,446,648
1,7,9,0.78,0.6970000000000001,0.2537,56,239,295
1,2,15,0.5,0.4848,0.4179,34,161,195
0,10,12,0.54,0.5152,0.3284,9,53,62
1,1,5,0.3,0.2424,0.5522,0,21,21
1,5,20,0.7,0.6515,0.1642,80,270,350
0,8,11,0.76,0.6970000000000001,0.2537,44,103,147
1,1,7,0.26,0.2576,0.2239,3,174,177
1,9,9,0.5,0.4848,0.3284,71,205,276
0,8,16,0.8,0.7273,0.19399999999999998,151,222,373
1,3,16,0.36,0.3636,0.0,115,275,390
0,8,3,0.64,0.5909,0.0896,0,6,6
0,7,15,0.86,0.8182,0.1642,36,102,138
0,5,9,0.52,0.5,0.1343,21,182,203
0,7,11,0.76,0.7121,0.1045,215,175,390
0,12,13,0.34,0.303,0.2985,24,97,121
1,4,4,0.34,0.3485,0.0896,0,6,6
1,4,13,0.5,0.4848,0.19399999999999998,355,288,643
0,7,11,0.86,0.8939,0.2985,27,79,106
1,7,22,0.66,0.6061,0.0896,88,188,276
1,6,7,0.5,0.4848,0.1642,20,506,526
1,2,21,0.24,0.2424,0.1343,4,74,78
0,4,7,0.36,0.3485,0.2239,3,67,70
0,4,17,0.46,0.4545,0.2985,25,284,309
1,1,9,0.16,0.1515,0.2537,2,40,42
1,5,7,0.62,0.5606,0.1642,7,352,359
0,12,7,0.24,0.2121,0.3582,11,265,276
1,11,0,0.22,0.2727,0.0,4,19,23
1,8,9,0.76,0.7273,0.1045,31,312,343
0,6,2,0.66,0.6061,0.0,2,5,7
0,3,14,0.32,0.303,0.2239,15,65,80
1,7,7,0.66,0.6212,0.3284,34,473,507
1,11,23,0.3,0.3182,0.1045,19,114,133
0,6,17,0.74,0.6667,0.2239,152,247,399
1,7,7,0.66,0.6212,0.2537,4,36,40
0,1,1,0.04,0.0758,0.1045,1,12,13
1,2,13,0.3,0.2727,0.3284,10,144,154
1,9,4,0.7,0.6667,0.0896,0,8,8
0,9,10,0.62,0.5152,0.0,2,27,29
1,6,3,0.64,0.5758,0.0,3,20,23
0,9,2,0.62,0.5909,0.1045,0,5,5
1,7,17,0.86,0.7424,0.1642,102,620,722
1,4,6,0.52,0.5,0.1642,10,123,133
1,2,12,0.5,0.4848,0.2537,25,199,224
1,12,12,0.24,0.2273,0.19399999999999998,52,172,224
0,6,0,0.66,0.6212,0.1642,15,39,54
1,7,19,0.74,0.6818,0.1642,88,543,631
0,10,18,0.6,0.5758,0.2239,46,493,539
0,1,12,0.26,0.2273,0.3284,5,74,79
0,10,22,0.58,0.5455,0.3582,13,94,107
0,8,4,0.66,0.6061,0.1642,5,5,10
0,1,21,0.16,0.19699999999999998,0.0896,0,20,20
1,7,23,0.74,0.6667,0.1045,12,90,102
1,2,8,0.24,0.2273,0.2239,12,429,441
1,6,1,0.76,0.7424,0.1642,3,28,31
0,9,3,0.62,0.5909,0.0896,15,30,45
0,3,21,0.26,0.303,0.0,8,55,63
0,3,14,0.36,0.3333,0.3582,25,64,89
0,12,5,0.2,0.2273,0.1045,1,4,5
1,12,23,0.26,0.303,0.0,5,115,120
1,10,18,0.54,0.5152,0.1343,52,540,592
0,2,21,0.36,0.3182,0.5224,8,35,43
0,9,10,0.7,0.6515,0.1642,107,137,244
1,1,0,0.26,0.303,0.0,2,26,28
0,4,12,0.46,0.4545,0.0,39,114,153
1,12,5,0.26,0.2576,0.19399999999999998,0,37,37
0,4,21,0.44,0.4394,0.1343,58,119,177
1,1,1,0.18,0.2121,0.1045,0,4,4
1,2,13,0.3,0.303,0.1642,64,197,261
0,9,7,0.58,0.5455,0.0896,14,348,362
0,6,3,0.62,0.6061,0.1642,22,25,47
1,11,10,0.4,0.4091,0.0,86,264,350
1,10,9,0.52,0.5,0.19399999999999998,23,320,343
1,7,10,0.86,0.7879,0.2985,98,268,366
0,3,16,0.34,0.303,0.3284,10,102,112
0,3,0,0.2,0.1818,0.3284,0,4,4
0,6,0,0.56,0.5303,0.0896,3,21,24
1,5,1,0.5,0.4848,0.0,20,84,104
1,12,13,0.3,0.3333,0.0,33,212,245
1,4,18,0.6,0.5909,0.2836,60,649,709
1,5,13,0.8,0.7879,0.2836,272,284,556
1,4,2,0.34,0.3333,0.19399999999999998,6,5,11
0,2,14,0.46,0.4545,0.6567,102,94,196
0,2,7,0.24,0.2424,0.1343,6,8,14
1,10,14,0.54,0.5152,0.2537,94,214,308
0,4,0,0.44,0.4394,0.2836,4,29,33
1,9,2,0.52,0.5,0.0,5,8,13
0,11,7,0.22,0.2273,0.19399999999999998,3,24,27
0,10,7,0.34,0.3333,0.19399999999999998,5,24,29
1,9,0,0.58,0.5455,0.2985,6,34,40
0,9,8,0.54,0.5152,0.3881,15,349,364
0,9,8,0.62,0.5455,0.1343,20,297,317
0,11,21,0.32,0.3485,0.0,19,99,118
1,3,20,0.56,0.5303,0.19399999999999998,89,182,271
1,12,0,0.3,0.303,0.1642,1,33,34
0,3,10,0.34,0.3182,0.2239,13,51,64
1,10,9,0.38,0.3939,0.1642,59,273,332
0,1,18,0.42,0.4242,0.2537,9,26,35
0,6,12,0.66,0.6212,0.2836,51,208,259
0,12,22,0.3,0.3333,0.0,5,99,104
0,12,9,0.24,0.2424,0.1642,3,20,23
0,6,8,0.68,0.6364,0.1045,25,59,84
1,5,4,0.56,0.5303,0.0,1,4,5
0,3,22,0.4,0.4091,0.3284,27,45,72
0,7,8,0.7,0.6667,0.19399999999999998,28,415,443
1,8,18,0.76,0.7121,0.2836,97,757,854
0,8,9,0.72,0.6515,0.2239,31,166,197
1,1,23,0.24,0.2576,0.1045,4,56,60
1,9,4,0.66,0.5909,0.0,7,15,22
1,12,16,0.42,0.4242,0.3582,37,297,334
1,4,6,0.34,0.3333,0.19399999999999998,10,18,28
1,7,6,0.66,0.5909,0.1642,3,123,126
0,11,11,0.32,0.303,0.3284,4,93,97
0,1,9,0.2,0.2273,0.0896,10,134,144
0,7,1,0.74,0.6970000000000001,0.1343,7,6,13
1,2,11,0.12,0.1061,0.2985,3,121,124
0,3,5,0.4,0.4091,0.1343,1,11,12
0,11,5,0.44,0.4394,0.2537,0,19,19
1,12,22,0.2,0.19699999999999998,0.19399999999999998,6,30,36
0,4,7,0.36,0.3333,0.3582,2,14,16
0,8,15,0.68,0.6364,0.3582,150,208,358
1,3,8,0.44,0.4394,0.2239,32,625,657
1,1,5,0.2,0.2121,0.1343,1,6,7
0,11,20,0.5,0.4848,0.2537,10,94,104
1,12,10,0.32,0.2879,0.4627,8,146,154
0,4,21,0.54,0.5152,0.1642,8,53,61
1,6,3,0.56,0.5303,0.1642,2,3,5
1,11,14,0.3,0.2879,0.2537,33,170,203
0,11,20,0.36,0.3485,0.1642,14,17,31
0,11,10,0.32,0.2727,0.5522,38,162,200
0,9,22,0.62,0.5455,0.0,15,112,127
1,4,16,0.42,0.4242,0.2239,36,199,235
1,3,10,0.26,0.2576,0.2239,20,118,138
0,3,3,0.42,0.4242,0.2985,2,9,11
1,11,3,0.24,0.2576,0.1045,0,6,6
1,10,18,0.46,0.4545,0.1343,174,299,473
1,5,13,0.66,0.6212,0.1642,69,201,270
0,8,7,0.64,0.6212,0.1642,17,247,264
1,10,15,0.72,0.6515,0.2537,150,320,470
1,8,16,0.8,0.7424,0.2836,113,328,441
0,12,20,0.22,0.2424,0.1045,10,62,72
1,4,2,0.36,0.3485,0.1642,0,5,5
0,8,16,0.76,0.7121,0.3284,70,220,290
1,9,23,0.66,0.5909,0.0896,57,88,145
0,6,19,0.72,0.6667,0.2836,121,254,375
1,7,22,0.62,0.5758,0.19399999999999998,13,122,135
1,3,18,0.6,0.6061,0.2239,61,580,641
0,3,7,0.24,0.2273,0.19399999999999998,4,19,23
1,3,3,0.36,0.3485,0.1343,0,2,2
1,2,6,0.1,0.1061,0.2239,1,71,72
0,5,7,0.52,0.5,0.2836,27,245,272
1,11,21,0.24,0.2273,0.19399999999999998,9,66,75
0,2,10,0.26,0.2576,0.19399999999999998,34,70,104
0,9,23,0.56,0.5303,0.0,11,70,81
1,8,5,0.56,0.5303,0.0896,4,30,34
1,6,22,0.66,0.6212,0.3881,21,166,187
0,5,4,0.5,0.4848,0.1642,2,3,5
0,5,2,0.48,0.4697,0.0,17,42,59
1,9,1,0.52,0.5,0.1045,2,19,21
1,10,3,0.42,0.4242,0.1343,2,27,29
0,11,18,0.42,0.4242,0.19399999999999998,8,184,192
1,6,6,0.48,0.4697,0.0,7,165,172
1,10,15,0.42,0.4242,0.1642,33,197,230
1,5,8,0.56,0.5303,0.1642,32,124,156
1,3,21,0.48,0.4697,0.1642,25,124,149
1,7,4,0.68,0.6364,0.1045,0,6,6
0,11,13,0.48,0.4697,0.19399999999999998,20,147,167
0,11,6,0.44,0.4394,0.2239,10,104,114
0,11,12,0.44,0.4394,0.0,120,226,346
1,4,6,0.42,0.4242,0.2239,3,108,111
0,2,18,0.24,0.2576,0.1045,3,152,155
1,5,15,0.66,0.6212,0.19399999999999998,131,260,391
1,9,17,0.66,0.6212,0.3284,127,744,871
1,5,14,0.6,0.6061,0.1045,226,292,518
1,9,3,0.58,0.5455,0.2836,4,6,10
1,6,6,0.64,0.5758,0.0896,10,37,47
1,1,12,0.2,0.2121,0.1642,5,62,67
1,12,5,0.24,0.2576,0.0896,1,12,13
1,6,1,0.54,0.5152,0.2239,9,5,14
0,4,19,0.62,0.5909,0.2836,40,220,260
0,3,21,0.24,0.2273,0.2537,0,27,27
0,1,22,0.24,0.2121,0.2985,0,9,9
1,10,4,0.36,0.3636,0.1045,0,8,8
0,12,11,0.26,0.2879,0.0896,15,100,115
0,10,5,0.26,0.2273,0.3582,0,1,1
0,7,21,0.7,0.6515,0.2239,85,167,252
1,3,22,0.44,0.4394,0.0,16,132,148
1,10,6,0.4,0.4091,0.0896,6,152,158
1,12,4,0.24,0.2576,0.1045,0,4,4
0,10,5,0.5,0.4848,0.1045,0,3,3
0,9,0,0.6,0.5455,0.0,37,136,173
0,5,3,0.44,0.4394,0.1343,9,7,16
0,12,4,0.26,0.303,0.0,2,9,11
1,9,6,0.56,0.5303,0.0896,5,164,169
0,4,0,0.62,0.6212,0.1045,11,13,24
0,8,2,0.62,0.6212,0.19399999999999998,0,15,15
0,7,18,0.66,0.6061,0.0896,35,281,316
0,4,3,0.42,0.4242,0.0,0,2,2
0,11,0,0.42,0.4242,0.2537,2,22,24
0,4,13,0.7,0.6515,0.3881,42,135,177
0,8,14,0.78,0.7273,0.19399999999999998,78,142,220
1,11,7,0.26,0.2727,0.1045,11,39,50
1,4,11,0.42,0.4242,0.4478,81,128,209
0,10,11,0.52,0.5,0.3284,23,132,155
0,5,2,0.52,0.5,0.0,6,4,10
0,5,22,0.5,0.4848,0.0896,29,86,115
1,1,6,0.12,0.1364,0.1642,0,86,86
1,3,9,0.46,0.4545,0.2537,5,281,286
1,12,8,0.24,0.19699999999999998,0.4627,1,32,33
0,8,14,0.76,0.7121,0.2239,43,104,147
1,2,4,0.28,0.2879,0.1045,0,1,1
1,1,11,0.18,0.2121,0.1045,1,62,63
0,4,4,0.46,0.4545,0.1343,0,6,6
1,8,16,0.76,0.6667,0.0,109,358,467
1,3,20,0.32,0.3182,0.19399999999999998,3,184,187
0,12,6,0.36,0.3788,0.0,1,71,72
1,7,20,0.86,0.7576,0.1642,52,375,427
0,4,12,0.66,0.6061,0.3284,38,135,173
1,10,22,0.56,0.5303,0.3881,38,87,125
1,6,1,0.6,0.5758,0.1642,1,13,14
0,2,12,0.24,0.2273,0.2239,3,61,64
0,3,15,0.52,0.5,0.2537,30,95,125
1,1,10,0.26,0.2273,0.3284,30,111,141
0,3,2,0.3,0.2879,0.2836,6,24,30
0,8,8,0.8,0.7273,0.19399999999999998,35,347,382
1,4,9,0.38,0.3939,0.0,45,169,214
0,2,16,0.36,0.3485,0.1343,16,98,114
1,7,4,0.66,0.5909,0.3881,1,1,2
0,6,3,0.72,0.7121,0.1045,0,2,2
1,11,18,0.36,0.3485,0.19399999999999998,10,563,573
0,10,5,0.44,0.4394,0.0,1,14,15
1,8,23,0.74,0.7121,0.1343,26,170,196
0,7,22,0.8,0.7727,0.19399999999999998,37,88,125
0,11,22,0.3,0.2727,0.2985,5,82,87
1,2,14,0.32,0.303,0.2239,47,229,276
1,4,3,0.32,0.303,0.2537,2,3,5
1,10,9,0.34,0.3333,0.1343,17,280,297
0,9,7,0.66,0.6061,0.19399999999999998,10,20,30
0,9,18,0.7,0.6667,0.19399999999999998,33,377,410
1,2,13,0.16,0.1212,0.4478,10,128,138
0,4,19,0.5,0.4848,0.19399999999999998,28,248,276
1,7,5,0.66,0.6364,0.0896,4,30,34
1,1,2,0.24,0.2121,0.3582,1,6,7
1,4,8,0.38,0.3939,0.1343,26,81,107
1,8,1,0.7,0.6667,0.19399999999999998,11,32,43
0,10,8,0.26,0.2576,0.2239,20,60,80
1,1,21,0.1,0.1061,0.2239,2,66,68
1,7,3,0.66,0.6212,0.2239,0,8,8
1,8,5,0.64,0.5909,0.1045,4,35,39
0,8,14,0.74,0.6818,0.0896,56,95,151
0,6,7,0.54,0.5152,0.2537,25,252,277
1,11,14,0.38,0.3939,0.3881,34,169,203
0,11,1,0.4,0.4091,0.1343,1,5,6
0,5,22,0.5,0.4848,0.2985,11,68,79
1,10,9,0.58,0.5455,0.1343,3,83,86
0,8,1,0.58,0.5455,0.19399999999999998,6,13,19
0,10,15,0.36,0.3333,0.2537,29,144,173
1,9,22,0.56,0.5303,0.0896,18,109,127
0,8,22,0.64,0.6061,0.1045,25,73,98
1,4,6,0.4,0.4091,0.1045,4,116,120
1,7,8,0.62,0.5909,0.2836,33,118,151
1,3,6,0.24,0.2424,0.1642,2,8,10
0,4,6,0.34,0.3333,0.1642,0,11,11
1,11,18,0.32,0.303,0.2836,12,530,542
1,6,16,0.72,0.6364,0.4925,67,349,416
0,10,22,0.44,0.4394,0.3284,22,106,128
1,9,23,0.48,0.4697,0.0896,8,49,57
1,3,22,0.36,0.3485,0.1343,7,127,134
0,7,3,0.64,0.6061,0.2239,21,26,47
1,8,3,0.66,0.6061,0.0,0,6,6
1,4,4,0.54,0.5152,0.0,2,10,12
0,1,8,0.12,0.1667,0.0,2,156,158
1,8,8,0.7,0.6667,0.0,27,578,605
1,6,13,0.8,0.6970000000000001,0.3284,77,244,321
1,12,15,0.36,0.3333,0.2537,51,56,107
0,7,19,0.74,0.6515,0.2239,101,155,256
0,12,22,0.44,0.4394,0.1343,12,94,106
1,11,17,0.36,0.3333,0.2985,112,298,410
0,1,18,0.26,0.2576,0.19399999999999998,1,184,185
0,6,19,0.64,0.6212,0.3582,51,335,386
1,10,6,0.44,0.4394,0.19399999999999998,4,19,23
0,12,23,0.2,0.2273,0.1045,6,31,37
0,5,14,0.68,0.6364,0.0,76,117,193
1,3,16,0.36,0.3333,0.2836,22,228,250
1,5,21,0.64,0.6061,0.2836,11,98,109
0,10,10,0.36,0.3333,0.2836,60,188,248
0,5,15,0.6,0.6212,0.3881,89,171,260
0,7,20,0.72,0.6970000000000001,0.2537,55,257,312
1,1,11,0.34,0.3333,0.1343,30,123,153
1,9,12,0.64,0.6212,0.3881,76,256,332
0,12,17,0.36,0.3485,0.1343,9,409,418
0,11,15,0.48,0.4697,0.1642,26,161,187
0,3,0,0.26,0.2273,0.3284,1,15,16
1,8,8,0.66,0.6212,0.1045,25,668,693
1,1,4,0.2,0.2121,0.1343,0,2,2
0,3,16,0.36,0.3485,0.19399999999999998,17,101,118
1,1,16,0.4,0.4091,0.2985,58,256,314
0,7,7,0.74,0.6818,0.1343,19,26,45
0,6,7,0.64,0.6061,0.19399999999999998,23,311,334
1,12,8,0.44,0.4394,0.1642,21,700,721
1,3,1,0.36,0.3333,0.2985,0,8,8
1,3,8,0.4,0.4091,0.2239,28,534,562
1,11,13,0.52,0.5,0.0,268,383,651
0,4,3,0.36,0.3485,0.19399999999999998,0,3,3
0,10,20,0.54,0.5152,0.0,30,167,197
1,12,15,0.28,0.2879,0.1343,69,246,315
0,5,22,0.54,0.5152,0.19399999999999998,26,94,120
0,5,9,0.46,0.4545,0.1343,45,96,141
0,8,11,0.72,0.6667,0.0,115,223,338
0,12,3,0.16,0.19699999999999998,0.0896,0,3,3
0,5,12,0.6,0.6212,0.0,41,185,226
0,1,20,0.18,0.2121,0.0896,4,55,59
0,4,3,0.26,0.2727,0.1343,0,4,4
1,5,20,0.62,0.6212,0.1642,113,174,287
1,1,21,0.28,0.2727,0.2239,10,81,91
0,12,1,0.18,0.2121,0.0896,3,8,11
0,12,4,0.22,0.2121,0.2239,0,1,1
0,3,16,0.5,0.4848,0.1045,40,125,165
1,12,22,0.26,0.2879,0.0896,7,141,148
0,3,13,0.32,0.2879,0.3582,17,82,99
0,2,6,0.12,0.1515,0.1045,0,36,36
1,1,8,0.16,0.1515,0.2239,3,29,32
1,5,18,0.72,0.6667,0.2239,97,749,846
0,3,15,0.36,0.3333,0.2985,31,75,106
0,10,0,0.46,0.4545,0.0,3,23,26
0,5,7,0.5,0.4848,0.1642,16,141,157
0,11,6,0.22,0.2273,0.1642,0,7,7
0,3,13,0.64,0.6212,0.2836,57,118,175
1,6,16,0.84,0.7273,0.2537,181,280,461
0,8,16,0.74,0.6515,0.1642,42,295,337
1,8,14,0.88,0.8029999999999999,0.3881,183,289,472
1,12,11,0.36,0.3333,0.3582,28,145,173
1,4,22,0.52,0.5,0.19399999999999998,29,219,248
0,7,0,0.78,0.7121,0.1642,19,26,45
1,2,2,0.42,0.4242,0.1343,2,7,9
1,6,5,0.54,0.5152,0.1343,4,13,17
1,8,17,0.78,0.6818,0.2239,108,762,870
1,7,14,0.78,0.7424,0.1642,82,189,271
1,10,5,0.38,0.3939,0.0896,6,4,10
1,6,13,0.58,0.5455,0.1343,51,174,225
0,6,18,0.76,0.6667,0.2985,87,365,452
0,3,7,0.26,0.2576,0.2239,2,106,108
1,2,3,0.1,0.0455,0.6866,0,14,14
1,11,11,0.4,0.4091,0.19399999999999998,121,130,251
1,4,9,0.4,0.4091,0.2537,61,290,351
0,3,17,0.5,0.4848,0.2836,30,238,268
1,9,18,0.82,0.7727,0.0,184,258,442
1,3,22,0.56,0.5303,0.1642,17,131,148
0,4,7,0.42,0.4242,0.4627,15,183,198
0,10,15,0.64,0.6212,0.2836,35,147,182
0,7,12,0.84,0.8029999999999999,0.2836,40,108,148
1,3,16,0.3,0.2727,0.2985,30,180,210
0,2,18,0.2,0.2121,0.1642,2,145,147
0,3,14,0.34,0.303,0.2985,10,61,71
1,10,16,0.7,0.6515,0.2836,86,411,497
1,1,14,0.16,0.1667,0.1642,19,163,182
1,11,0,0.3,0.2879,0.19399999999999998,3,20,23
0,2,19,0.34,0.303,0.3582,5,54,59
0,11,14,0.42,0.4242,0.4627,13,200,213
1,10,7,0.46,0.4545,0.1045,9,498,507
1,3,2,0.36,0.3333,0.2985,1,6,7
1,9,22,0.54,0.5152,0.1045,35,252,287
0,3,20,0.36,0.3333,0.3284,9,29,38
0,5,1,0.52,0.5,0.1343,6,8,14
1,10,16,0.56,0.5303,0.2985,76,371,447
1,9,12,0.72,0.6667,0.2985,228,460,688
0,12,13,0.4,0.4091,0.4627,17,177,194
0,10,13,0.5,0.4848,0.0,136,186,322
0,7,4,0.64,0.5758,0.2239,2,4,6
1,1,4,0.2,0.2576,0.0,0,1,1
1,2,23,0.36,0.3485,0.19399999999999998,10,72,82
0,6,22,0.58,0.5455,0.2239,29,159,188
1,12,10,0.26,0.2273,0.3284,13,105,118
1,9,13,0.72,0.6970000000000001,0.1045,39,152,191
0,2,9,0.16,0.1818,0.1343,3,124,127
1,11,11,0.38,0.3939,0.2239,33,185,218
1,10,5,0.3,0.2879,0.19399999999999998,0,11,11
1,8,13,0.74,0.6667,0.0,68,232,300
0,6,9,0.66,0.6212,0.0896,75,131,206
1,5,8,0.46,0.4545,0.19399999999999998,19,608,627
1,7,9,0.72,0.6818,0.1343,55,289,344
0,10,14,0.52,0.5,0.2239,192,216,408
0,8,12,0.9,0.8485,0.2985,161,209,370
0,10,4,0.5,0.4848,0.19399999999999998,0,3,3
0,6,12,0.64,0.6061,0.1045,123,212,335
1,4,4,0.38,0.3939,0.2836,0,1,1
0,6,10,0.62,0.5909,0.0896,83,168,251
1,12,4,0.14,0.1667,0.1045,0,3,3
0,10,3,0.44,0.4394,0.0,10,20,30
1,4,10,0.4,0.4091,0.1045,132,228,360
1,1,14,0.32,0.303,0.2537,51,229,280
0,1,9,0.12,0.0758,0.5224,0,19,19
1,1,23,0.16,0.1364,0.2985,2,36,38
1,4,12,0.44,0.4394,0.1343,45,180,225
0,5,14,0.88,0.8029999999999999,0.0,142,185,327
1,10,22,0.6,0.5909,0.2836,63,201,264
1,12,8,0.14,0.1667,0.1045,5,43,48
0,9,22,0.64,0.5909,0.1343,24,120,144
1,2,8,0.38,0.3939,0.3284,17,452,469
1,4,23,0.54,0.5152,0.2239,10,72,82
0,4,20,0.32,0.3182,0.19399999999999998,2,75,77
0,12,15,0.48,0.4697,0.3881,4,57,61
1,6,15,0.66,0.6212,0.2239,203,260,463
1,5,2,0.54,0.5152,0.1642,22,60,82
1,1,11,0.26,0.2121,0.4925,33,142,175
0,11,8,0.34,0.3485,0.0896,8,394,402
1,3,13,0.6,0.6212,0.6418,35,198,233
1,6,1,0.66,0.6061,0.1343,16,107,123
0,12,7,0.18,0.2121,0.0896,2,104,106
1,3,2,0.42,0.4242,0.19399999999999998,0,4,4
1,3,23,0.36,0.3485,0.19399999999999998,5,59,64
1,1,13,0.22,0.2121,0.2836,6,118,124
1,5,7,0.6,0.5758,0.19399999999999998,14,469,483
0,10,15,0.68,0.6364,0.1642,198,209,407
1,2,7,0.22,0.2727,0.0,6,273,279
0,11,10,0.34,0.3182,0.2239,15,95,110
0,10,6,0.24,0.2879,0.0,4,82,86
0,11,5,0.22,0.2576,0.0896,1,3,4
1,6,18,0.9,0.8182,0.0,81,591,672
1,6,22,0.82,0.7576,0.1045,31,226,257
1,7,3,0.72,0.7121,0.1343,6,27,33
0,1,13,0.2,0.1818,0.3284,7,95,102
0,5,5,0.5,0.4848,0.19399999999999998,1,20,21
0,12,18,0.36,0.3485,0.1642,11,379,390
1,12,9,0.4,0.4091,0.2537,9,94,103
1,10,16,0.68,0.6364,0.0896,108,433,541
0,12,10,0.32,0.303,0.2537,31,161,192
0,1,5,0.1,0.1061,0.2537,0,3,3
0,3,13,0.36,0.3485,0.2239,14,84,98
0,8,15,0.7,0.6667,0.1343,31,87,118
0,1,17,0.36,0.3333,0.3284,7,190,197
1,10,20,0.48,0.4697,0.19399999999999998,35,160,195
0,4,6,0.34,0.3182,0.2836,2,47,49
1,12,5,0.2,0.2576,0.0,0,6,6
0,1,10,0.16,0.1515,0.2537,7,50,57
0,5,10,0.7,0.6515,0.2239,110,166,276
0,4,3,0.34,0.3333,0.1642,0,1,1
0,2,16,0.22,0.2273,0.1642,7,79,86
1,1,8,0.12,0.1515,0.1045,3,89,92
0,3,12,0.28,0.2727,0.19399999999999998,17,73,90
1,3,15,0.7,0.6364,0.0,86,197,283
1,12,18,0.5,0.4848,0.0896,26,666,692
1,7,18,0.6,0.5455,0.19399999999999998,51,126,177
0,5,4,0.54,0.5152,0.0,2,2,4
1,4,2,0.32,0.3182,0.19399999999999998,0,3,3
0,4,13,0.44,0.4394,0.2985,219,148,367
1,2,16,0.42,0.4242,0.0896,17,270,287
0,1,6,0.2,0.1818,0.2836,0,8,8
0,10,14,0.62,0.6212,0.1642,32,137,169
0,3,3,0.2,0.1515,0.5821,0,1,1
1,7,16,0.86,0.7727,0.2239,208,279,487
0,1,0,0.24,0.2273,0.2239,1,6,7
1,8,8,0.68,0.6364,0.19399999999999998,33,649,682
1,12,21,0.3,0.303,0.1642,7,165,172
1,9,10,0.72,0.6970000000000001,0.1343,53,171,224
1,9,7,0.44,0.4394,0.19399999999999998,17,539,556
0,12,16,0.44,0.4394,0.3881,52,143,195
1,1,5,0.26,0.2424,0.2836,0,33,33
1,10,8,0.6,0.6061,0.3881,24,713,737
1,10,3,0.36,0.3636,0.0896,0,6,6
1,4,20,0.56,0.5303,0.0896,45,198,243
0,10,15,0.58,0.5455,0.2836,28,166,194
1,7,1,0.66,0.6061,0.1343,3,18,21
0,12,3,0.4,0.4091,0.2836,1,17,18
1,12,23,0.48,0.4697,0.2537,5,91,96
0,10,21,0.52,0.5,0.0,17,140,157
1,2,8,0.3,0.3182,0.0896,9,567,576
1,10,10,0.5,0.4848,0.2985,167,276,443
1,6,5,0.66,0.6212,0.1642,1,42,43
1,4,8,0.36,0.3333,0.3284,36,553,589
0,5,20,0.66,0.6212,0.0896,39,241,280
1,3,6,0.36,0.3333,0.3582,4,111,115
0,2,2,0.2,0.2273,0.0896,1,19,20
0,10,21,0.42,0.4242,0.1642,31,112,143
1,8,13,0.78,0.6970000000000001,0.1642,79,175,254
1,1,9,0.16,0.1364,0.2836,8,145,153
0,8,19,0.72,0.6970000000000001,0.1642,68,160,228
0,2,11,0.52,0.5,0.2537,10,43,53
0,1,9,0.16,0.1515,0.2239,8,39,47
1,5,8,0.58,0.5455,0.0,38,681,719
0,8,5,0.7,0.6667,0.2985,1,11,12
1,3,7,0.46,0.4545,0.3582,14,353,367
0,3,4,0.2,0.1515,0.5224,1,0,1
0,7,7,0.8,0.7727,0.1343,6,29,35
0,6,1,0.62,0.5909,0.1642,2,12,14
0,11,9,0.26,0.2576,0.19399999999999998,6,207,213
0,7,21,0.66,0.6061,0.2537,46,158,204
1,7,15,0.92,0.8939,0.2985,65,173,238
1,6,18,0.86,0.7879,0.19399999999999998,78,562,640
0,5,18,0.64,0.6212,0.1343,70,480,550
0,10,15,0.54,0.5152,0.1343,21,99,120
1,12,20,0.36,0.3485,0.19399999999999998,23,178,201
1,2,0,0.26,0.2424,0.2537,2,27,29
1,4,19,0.36,0.3485,0.1343,29,110,139
0,6,14,0.76,0.6970000000000001,0.19399999999999998,73,142,215
0,3,8,0.2,0.19699999999999998,0.2239,6,8,14
0,6,17,0.72,0.6515,0.2537,142,202,344
1,10,9,0.54,0.5152,0.2836,35,331,366
1,10,19,0.52,0.5,0.1045,36,478,514
0,3,11,0.28,0.2727,0.19399999999999998,6,52,58
1,12,0,0.24,0.2576,0.1045,3,45,48
1,5,10,0.54,0.5152,0.2537,6,53,59
1,11,18,0.36,0.3636,0.1045,34,237,271
1,5,1,0.62,0.5758,0.0896,8,34,42
0,3,9,0.22,0.2273,0.1343,12,138,150
0,10,17,0.6,0.5758,0.2537,70,534,604
1,4,18,0.64,0.6061,0.2836,105,670,775
0,10,4,0.4,0.4091,0.0,1,5,6
1,7,0,0.7,0.6667,0.0896,12,46,58
0,4,17,0.56,0.5303,0.1045,39,372,411
1,4,19,0.36,0.3182,0.5224,1,34,35
1,8,15,0.84,0.7576,0.19399999999999998,110,168,278
0,6,15,0.7,0.6364,0.4478,58,127,185
1,8,21,0.66,0.6212,0.0,90,248,338
0,11,12,0.54,0.5152,0.2836,63,193,256
1,9,19,0.7,0.6667,0.2239,140,152,292
0,8,9,0.7,0.6515,0.0,51,139,190
0,3,23,0.22,0.19699999999999998,0.4179,0,9,9
0,10,4,0.4,0.4091,0.0896,3,4,7
0,8,0,0.66,0.6212,0.0,11,18,29
1,11,2,0.36,0.3333,0.2537,0,5,5
0,8,14,0.76,0.6818,0.4179,77,127,204
0,2,9,0.16,0.1364,0.2985,6,127,133
1,1,22,0.3,0.303,0.0896,10,104,114
1,5,1,0.62,0.5909,0.2985,14,45,59
1,3,2,0.5,0.4848,0.19399999999999998,0,2,2
1,9,7,0.52,0.5,0.0,18,474,492
0,11,3,0.44,0.4394,0.1343,0,4,4
1,11,8,0.32,0.3333,0.1045,32,87,119
0,12,1,0.3,0.3182,0.0896,20,54,74
0,1,14,0.3,0.3333,0.0,11,57,68
0,5,21,0.54,0.5152,0.2836,29,180,209
1,11,19,0.26,0.2424,0.2537,9,74,83
0,8,13,0.72,0.6970000000000001,0.2537,144,233,377
1,5,14,0.72,0.6515,0.0896,361,369,730
0,7,1,0.66,0.6212,0.2537,4,21,25
1,8,16,0.9,0.7879,0.2537,111,417,528
1,12,16,0.5,0.4848,0.1045,37,308,345
0,2,3,0.22,0.2273,0.1343,0,1,1
0,4,21,0.62,0.6061,0.2537,41,149,190
1,5,16,0.72,0.6667,0.1642,46,352,398
1,2,22,0.32,0.3485,0.0,3,108,111
1,2,22,0.32,0.3182,0.19399999999999998,11,107,118
0,10,21,0.4,0.4091,0.0,10,128,138
0,6,17,0.72,0.6364,0.2836,73,485,558
1,4,3,0.52,0.5,0.1343,18,27,45
1,8,5,0.6,0.5909,0.19399999999999998,3,37,40
0,6,9,0.7,0.6364,0.2239,33,227,260
1,7,13,0.84,0.7879,0.2836,63,176,239
0,4,0,0.36,0.3485,0.19399999999999998,3,30,33
1,4,22,0.42,0.4242,0.0896,9,153,162
0,5,19,0.6,0.6061,0.19399999999999998,59,305,364
0,3,4,0.28,0.2727,0.19399999999999998,0,1,1
0,4,5,0.38,0.3939,0.2537,1,4,5
0,1,18,0.22,0.2273,0.1642,1,132,133
1,3,16,0.48,0.4697,0.6418,60,245,305
0,10,12,0.5,0.4848,0.1343,8,45,53
1,11,12,0.4,0.4091,0.2836,28,262,290
0,1,21,0.24,0.2273,0.2537,3,54,57
0,9,23,0.64,0.6061,0.1642,30,68,98
0,3,2,0.34,0.3182,0.2537,0,1,1
1,7,1,0.68,0.6364,0.1343,49,119,168
1,5,7,0.56,0.5303,0.0,14,426,440
1,4,3,0.34,0.3182,0.2239,3,23,26
1,3,4,0.44,0.4394,0.0,0,3,3
0,7,0,0.62,0.6061,0.19399999999999998,42,68,110
0,7,0,0.7,0.6515,0.1642,19,36,55
1,8,10,0.8,0.7576,0.2239,72,133,205
0,6,21,0.64,0.5909,0.0896,49,159,208
0,1,18,0.12,0.1212,0.2537,5,44,49
1,1,15,0.28,0.2424,0.4478,29,139,168
1,8,1,0.62,0.5909,0.1343,21,92,113
1,4,17,0.62,0.6212,0.2537,251,309,560
0,11,14,0.38,0.3939,0.3582,13,99,112
1,6,4,0.54,0.5152,0.0896,2,6,8
0,10,4,0.48,0.4697,0.0,1,3,4
0,10,17,0.5,0.4848,0.4627,31,291,322
0,10,12,0.62,0.6212,0.3284,34,180,214
1,1,21,0.26,0.2273,0.3582,4,117,121
1,1,17,0.42,0.4242,0.0,16,397,413
1,10,23,0.54,0.5152,0.0,6,111,117
0,8,20,0.8,0.7273,0.19399999999999998,34,258,292
0,2,23,0.3,0.303,0.1642,9,45,54
0,6,6,0.54,0.5152,0.4179,7,98,105
1,6,4,0.56,0.5303,0.1642,1,13,14
1,1,15,0.4,0.4091,0.2836,89,241,330
0,4,4,0.46,0.4545,0.19399999999999998,0,1,1
0,11,1,0.32,0.303,0.2985,5,57,62
1,8,12,0.78,0.6970000000000001,0.19399999999999998,96,180,276
0,9,14,0.72,0.6667,0.2537,54,144,198
1,6,13,0.8,0.7121,0.2985,63,185,248
1,8,19,0.8,0.7879,0.1642,98,509,607
1,12,7,0.26,0.2576,0.19399999999999998,3,366,369
1,6,1,0.64,0.6212,0.2239,0,34,34
1,6,6,0.74,0.6970000000000001,0.0,4,118,122
1,12,14,0.26,0.2121,0.5224,25,94,119
0,10,19,0.58,0.5455,0.2239,33,285,318
1,8,5,0.62,0.5909,0.0,2,33,35
1,3,13,0.3,0.303,0.1343,16,148,164
0,1,0,0.14,0.1667,0.1045,2,10,12
1,2,15,0.52,0.5,0.4179,24,150,174
0,8,2,0.62,0.5909,0.0,10,59,69
0,4,4,0.24,0.2424,0.1642,0,5,5
0,7,18,0.8,0.8029999999999999,0.1343,80,450,530
1,6,10,0.74,0.6667,0.19399999999999998,40,144,184
0,8,10,0.72,0.6970000000000001,0.2239,97,163,260
0,9,0,0.52,0.5,0.1045,7,53,60
1,3,8,0.32,0.3182,0.1642,38,555,593
1,3,3,0.44,0.4394,0.0,2,24,26
0,1,11,0.22,0.2727,0.0,9,50,59
1,2,4,0.1,0.0455,0.7164,0,1,1
1,8,21,0.72,0.6970000000000001,0.1045,51,157,208
0,5,11,0.58,0.5455,0.19399999999999998,63,133,196
0,10,11,0.4,0.4091,0.2239,26,100,126
0,3,17,0.4,0.4091,0.2239,28,245,273
0,2,9,0.12,0.1212,0.2239,8,132,140
1,9,8,0.7,0.6667,0.0,24,622,646
0,9,3,0.58,0.5455,0.0896,7,7,14
0,8,13,0.8,0.7424,0.3582,33,154,187
0,7,20,0.7,0.6515,0.2239,92,251,343
1,4,10,0.4,0.4091,0.2985,38,103,141
0,1,20,0.2,0.2273,0.1045,3,49,52
1,12,20,0.32,0.3333,0.1343,12,209,221
0,10,16,0.54,0.5152,0.19399999999999998,68,242,310
1,4,19,0.5,0.4848,0.3881,62,379,441
0,6,4,0.5,0.4848,0.2836,0,4,4
1,2,20,0.34,0.3485,0.1045,8,155,163
0,4,22,0.5,0.4848,0.1045,21,49,70
1,12,2,0.34,0.3485,0.0896,8,79,87
1,10,10,0.36,0.3333,0.2836,21,147,168
0,10,3,0.42,0.4242,0.1343,11,31,42
1,6,4,0.6,0.6212,0.2537,0,6,6
1,6,11,0.64,0.6212,0.4925,71,168,239
0,9,21,0.58,0.5455,0.0,30,195,225
1,7,9,0.58,0.5455,0.19399999999999998,32,175,207
1,6,6,0.54,0.5152,0.1343,9,142,151
0,7,7,0.66,0.5909,0.1045,13,279,292
1,11,12,0.44,0.4394,0.3284,48,214,262
1,6,3,0.64,0.5758,0.0896,10,32,42
0,9,15,0.74,0.6667,0.2985,134,270,404
0,4,1,0.42,0.4242,0.1343,2,11,13
0,1,7,0.16,0.1515,0.2239,5,103,108
0,8,5,0.7,0.6667,0.0896,1,14,15
1,7,4,0.66,0.6212,0.1045,3,6,9
1,7,7,0.7,0.6667,0.0896,14,455,469
1,11,9,0.32,0.3333,0.1343,11,257,268
0,9,20,0.64,0.5758,0.1343,24,227,251
0,12,15,0.4,0.4091,0.2537,7,144,151
0,7,6,0.72,0.6970000000000001,0.1045,8,126,134
1,7,22,0.82,0.8029999999999999,0.1343,63,162,225
0,5,14,0.74,0.6970000000000001,0.2836,183,168,351
1,10,19,0.54,0.5152,0.1642,19,213,232
0,1,12,0.2,0.19699999999999998,0.19399999999999998,12,66,78
0,4,20,0.34,0.3182,0.2836,29,56,85
0,11,13,0.34,0.3182,0.2239,31,146,177
0,7,18,0.86,0.8333,0.3881,57,415,472
0,11,13,0.54,0.5152,0.1642,31,165,196
0,7,18,0.86,0.8029999999999999,0.2985,39,472,511
1,1,16,0.28,0.2273,0.5224,13,163,176
1,8,10,0.7,0.6515,0.0896,66,159,225
0,3,13,0.5,0.4848,0.2239,35,77,112
1,8,3,0.64,0.5758,0.2537,11,42,53
0,1,0,0.26,0.2273,0.3881,5,8,13
1,11,0,0.34,0.3333,0.1642,10,40,50
1,4,9,0.48,0.4697,0.1343,47,316,363
1,3,2,0.52,0.5,0.2985,0,1,1
1,3,17,0.56,0.5303,0.0896,233,308,541
1,9,15,0.64,0.6212,0.1642,215,342,557
1,11,21,0.44,0.4394,0.2239,44,127,171
0,10,7,0.24,0.2879,0.0,11,216,227
0,1,0,0.16,0.1818,0.1045,0,33,33
1,12,17,0.26,0.2273,0.3284,26,97,123
0,10,19,0.46,0.4545,0.0,53,140,193
0,9,18,0.7,0.6515,0.1642,67,472,539
0,6,14,0.72,0.6667,0.0896,58,100,158
0,4,7,0.34,0.3333,0.1642,2,17,19
1,5,22,0.5,0.4848,0.1045,36,196,232
0,7,22,0.74,0.6970000000000001,0.2985,25,71,96
0,4,23,0.64,0.6212,0.2239,18,30,48
0,9,6,0.62,0.5152,0.1343,3,54,57
0,6,7,0.56,0.5303,0.4179,19,346,365
0,6,7,0.62,0.5909,0.1045,18,281,299
0,1,21,0.14,0.1364,0.19399999999999998,1,37,38
1,10,22,0.52,0.5,0.2537,41,116,157
1,2,2,0.42,0.4242,0.2836,1,4,5
1,6,12,0.7,0.6364,0.1642,111,292,403
0,9,0,0.56,0.5303,0.0896,5,11,16
0,12,2,0.26,0.2727,0.1343,2,2,4
0,11,13,0.5,0.4848,0.1343,13,121,134
1,1,18,0.2,0.2121,0.1343,9,280,289
1,12,9,0.26,0.2424,0.0,16,33,49
1,7,1,0.66,0.5909,0.19399999999999998,7,20,27
0,8,19,0.66,0.6061,0.3284,31,241,272
0,6,9,0.74,0.6970000000000001,0.1343,33,194,227
0,3,7,0.24,0.2424,0.1642,18,123,141
0,6,15,0.74,0.6515,0.0,174,229,403
1,5,10,0.7,0.6515,0.0,189,175,364
0,10,9,0.48,0.4697,0.2239,14,226,240
0,6,13,0.9,0.8182,0.0896,18,118,136
0,4,9,0.32,0.2879,0.3582,11,162,173
0,5,9,0.46,0.4545,0.2836,20,164,184
1,9,13,0.6,0.6212,0.2537,55,234,289
0,6,23,0.74,0.6667,0.1642,10,59,69
1,10,0,0.64,0.5758,0.0,11,65,76
1,11,20,0.52,0.5,0.2836,31,273,304
1,5,14,0.76,0.7121,0.2537,317,230,547
0,1,6,0.04,0.0758,0.1045,0,1,1
0,12,13,0.5,0.4848,0.3582,14,150,164
1,8,21,0.7,0.6515,0.1642,58,248,306
0,9,5,0.62,0.5455,0.1343,0,14,14
0,12,14,0.44,0.4394,0.19399999999999998,1,24,25
1,6,10,0.6,0.6212,0.2985,145,348,493
0,7,10,0.78,0.7424,0.0,29,72,101
0,12,3,0.46,0.4545,0.19399999999999998,0,3,3
0,9,19,0.68,0.6364,0.1343,63,373,436
0,12,23,0.28,0.3182,0.0,6,88,94
1,4,9,0.4,0.4091,0.19399999999999998,29,239,268
1,9,1,0.56,0.5303,0.2239,20,104,124
1,11,22,0.24,0.2273,0.2537,7,69,76
1,10,16,0.42,0.4242,0.19399999999999998,61,316,377
0,1,1,0.14,0.1212,0.2836,0,2,2
1,1,14,0.2,0.19699999999999998,0.19399999999999998,6,89,95
1,5,21,0.6,0.6061,0.1343,74,156,230
0,4,5,0.24,0.2576,0.1045,1,12,13
1,9,18,0.58,0.5455,0.1343,27,140,167
0,2,10,0.44,0.4394,0.2239,17,78,95
1,12,7,0.24,0.2121,0.3582,0,13,13
0,3,19,0.44,0.4394,0.3284,18,150,168
1,11,6,0.24,0.2121,0.2836,1,9,10
1,4,6,0.3,0.2879,0.2239,3,117,120
0,10,9,0.5,0.4848,0.0,66,119,185
1,12,13,0.36,0.3485,0.19399999999999998,41,230,271
1,8,22,0.62,0.5758,0.3582,46,136,182
1,7,2,0.74,0.6667,0.0,4,14,18
0,12,10,0.3,0.2879,0.2537,10,108,118
1,10,19,0.56,0.5303,0.2239,68,268,336
0,3,14,0.4,0.4091,0.0,145,134,279
1,3,9,0.48,0.4697,0.4179,22,299,321
0,10,11,0.5,0.4848,0.1642,59,109,168
0,8,10,0.74,0.6515,0.1045,44,86,130
1,3,23,0.56,0.5303,0.2239,10,53,63
0,9,22,0.6,0.5455,0.0896,19,102,121
1,5,9,0.52,0.5,0.1642,63,128,191
0,1,20,0.24,0.2576,0.1045,1,53,54
0,7,22,0.72,0.6667,0.0,37,143,180
1,2,6,0.22,0.2273,0.1343,1,8,9
1,6,18,0.76,0.6667,0.4478,100,691,791
1,12,16,0.44,0.4394,0.1045,85,358,443
1,5,10,0.62,0.5909,0.0896,52,139,191
0,9,2,0.66,0.6061,0.19399999999999998,17,43,60
1,7,3,0.66,0.5909,0.0896,0,2,2
0,12,16,0.36,0.3636,0.1045,35,51,86
0,4,9,0.36,0.3182,0.4925,68,74,142
0,3,11,0.54,0.5152,0.2836,55,104,159
1,12,11,0.28,0.2424,0.4478,23,80,103
0,1,8,0.02,0.0,0.3284,1,26,27
1,11,2,0.24,0.2121,0.2985,0,1,1
0,8,9,0.68,0.6364,0.2537,36,151,187
1,2,7,0.3,0.2879,0.19399999999999998,3,318,321
1,12,8,0.24,0.2576,0.1045,13,665,678
1,12,21,0.24,0.2273,0.2537,12,51,63
1,6,13,0.64,0.6212,0.3582,85,189,274
1,5,12,0.64,0.6061,0.19399999999999998,44,220,264
0,5,20,0.7,0.6515,0.1642,56,284,340
1,7,12,0.84,0.7879,0.2836,59,215,274
1,2,3,0.42,0.4242,0.1343,0,2,2
1,4,11,0.32,0.2879,0.3582,10,91,101
0,8,1,0.68,0.6364,0.0896,8,13,21
0,1,21,0.18,0.19699999999999998,0.1642,6,22,28
1,10,20,0.62,0.5455,0.1343,20,286,306
1,4,20,0.64,0.6212,0.2239,86,205,291
1,10,12,0.64,0.6061,0.2239,74,258,332
1,2,9,0.26,0.2879,0.0896,6,256,262
1,8,20,0.74,0.7121,0.2239,65,371,436
0,6,23,0.66,0.6212,0.1045,24,107,131
0,11,19,0.44,0.4394,0.0896,18,234,252
1,9,1,0.68,0.6364,0.1642,18,37,55
1,12,18,0.28,0.2576,0.2985,1,42,43
1,7,23,0.76,0.7273,0.0,34,155,189
1,8,22,0.66,0.6212,0.0,90,171,261
0,7,9,0.82,0.7424,0.19399999999999998,23,163,186
1,9,19,0.62,0.6212,0.2537,38,470,508
1,8,1,0.66,0.6061,0.0896,5,28,33
1,11,0,0.22,0.2121,0.2537,3,31,34
1,8,17,0.82,0.7273,0.19399999999999998,130,767,897
0,1,18,0.3,0.2879,0.2537,15,69,84
1,8,12,0.84,0.7576,0.1045,85,192,277
0,7,12,0.84,0.8182,0.0896,26,127,153
1,2,10,0.3,0.303,0.1642,0,10,10
1,11,12,0.36,0.3182,0.4627,74,320,394
0,3,14,0.44,0.4394,0.2985,0,12,12
0,3,16,0.42,0.4242,0.0,92,132,224
0,9,18,0.6,0.5606,0.1045,39,453,492
0,4,0,0.44,0.4394,0.0,6,21,27
0,5,20,0.56,0.5303,0.1343,24,189,213
1,1,16,0.54,0.5152,0.4478,30,277,307
1,10,21,0.46,0.4545,0.19399999999999998,28,301,329
0,8,12,0.7,0.6667,0.2239,98,183,281
1,9,16,0.72,0.6515,0.1642,90,419,509
1,2,7,0.2,0.2121,0.1642,5,225,230
0,5,23,0.66,0.5909,0.1642,48,87,135
1,12,16,0.38,0.3939,0.19399999999999998,45,372,417
1,11,10,0.32,0.303,0.3284,13,148,161
1,9,9,0.72,0.6970000000000001,0.2239,30,293,323
0,5,8,0.48,0.4697,0.2239,21,350,371
1,2,16,0.36,0.3788,0.1045,64,216,280
1,12,12,0.38,0.3939,0.0896,89,364,453
0,3,16,0.4,0.4091,0.1045,27,80,107
0,9,19,0.64,0.6061,0.1045,101,232,333
0,12,22,0.24,0.19699999999999998,0.4478,0,13,13
1,11,15,0.4,0.4091,0.4179,51,255,306
0,1,18,0.08,0.0909,0.19399999999999998,0,54,54
1,11,1,0.32,0.3182,0.1642,5,19,24
1,12,21,0.28,0.3182,0.0,13,200,213
1,7,2,0.72,0.6818,0.0896,1,6,7
1,7,10,0.74,0.6667,0.0,78,190,268
1,3,5,0.18,0.1818,0.2239,0,25,25
1,2,12,0.32,0.3333,0.0896,1,44,45
1,4,22,0.48,0.4697,0.2985,20,90,110
1,8,17,0.64,0.5909,0.1045,76,267,343
1,6,18,0.7,0.6364,0.2836,110,703,813
0,7,5,0.64,0.5758,0.1045,2,30,32
1,6,2,0.56,0.5303,0.2836,2,7,9
0,1,22,0.22,0.2576,0.0896,0,33,33
0,11,14,0.52,0.5,0.2537,113,250,363
1,1,7,0.22,0.2424,0.1045,1,239,240
1,9,22,0.48,0.4697,0.0,15,76,91
1,10,17,0.6,0.5909,0.1642,112,774,886
1,11,12,0.42,0.4242,0.0,70,243,313
1,7,20,0.7,0.6667,0.1642,124,254,378
0,3,13,0.3,0.2879,0.2239,14,69,83
0,12,3,0.46,0.4545,0.1343,2,3,5
0,3,11,0.36,0.3485,0.1642,26,52,78
1,5,12,0.56,0.5303,0.1343,64,237,301
0,8,14,0.7,0.6667,0.3881,78,157,235
1,1,17,0.54,0.5152,0.1343,87,235,322
0,3,2,0.32,0.3485,0.0,0,4,4
1,12,0,0.4,0.4091,0.1343,15,103,118
0,4,1,0.38,0.3939,0.1343,6,31,37
1,9,5,0.64,0.5758,0.3284,3,45,48
0,7,4,0.72,0.7121,0.0896,0,6,6
0,6,1,0.66,0.6061,0.1343,2,19,21
1,9,21,0.52,0.5,0.1045,51,145,196
0,11,21,0.28,0.2727,0.1642,3,108,111
1,4,9,0.4,0.4091,0.3582,6,302,308
1,5,2,0.6,0.5606,0.1642,2,10,12
0,11,9,0.34,0.3485,0.0,13,68,81
0,11,21,0.46,0.4545,0.2537,4,86,90
0,6,9,0.7,0.6515,0.2239,62,156,218
0,8,1,0.68,0.6364,0.2239,17,69,86
0,7,17,0.88,0.8485,0.1045,35,271,306
0,4,11,0.54,0.5152,0.1642,19,53,72
1,4,8,0.44,0.4394,0.19399999999999998,22,595,617
0,5,16,0.74,0.6970000000000001,0.2836,194,167,361
1,11,12,0.4,0.4091,0.2836,35,207,242
1,7,14,0.9,0.8182,0.1642,190,357,547
0,11,1,0.34,0.3636,0.0,0,10,10
0,10,21,0.44,0.4394,0.1343,32,169,201
0,6,15,0.7,0.6515,0.0,161,256,417
1,3,20,0.4,0.4091,0.5224,12,209,221
0,3,16,0.34,0.3485,0.0896,10,92,102
1,12,10,0.4,0.4091,0.2836,39,180,219
0,2,2,0.22,0.2273,0.1343,4,0,4
1,11,1,0.3,0.303,0.1642,0,8,8
1,7,19,0.9,0.8636,0.3284,80,534,614
1,11,13,0.36,0.3333,0.3582,110,339,449
0,9,22,0.62,0.5152,0.0896,21,166,187
0,10,22,0.3,0.3333,0.0,13,58,71
0,4,10,0.62,0.5606,0.2836,9,45,54
0,9,6,0.56,0.5303,0.1045,6,116,122
1,8,19,0.62,0.5909,0.19399999999999998,33,266,299
0,2,6,0.22,0.2727,0.0,1,6,7
1,10,22,0.46,0.4545,0.2985,27,170,197
1,5,6,0.52,0.5,0.2239,3,14,17
1,12,7,0.24,0.2424,0.1343,7,56,63
0,11,16,0.32,0.2879,0.4179,8,187,195
0,5,0,0.52,0.5,0.1045,20,78,98
0,7,3,0.72,0.6818,0.1642,2,1,3
0,1,8,0.12,0.1212,0.2836,4,184,188
0,12,1,0.26,0.303,0.0,0,8,8
1,8,18,0.74,0.6667,0.2239,80,768,848
1,8,23,0.62,0.5758,0.2537,34,124,158
0,10,11,0.6,0.5909,0.1642,31,92,123
1,4,7,0.4,0.4091,0.1343,15,391,406
0,12,9,0.26,0.303,0.0,19,175,194
1,3,0,0.58,0.5455,0.0,45,111,156
0,10,2,0.42,0.4242,0.1343,2,3,5
1,12,16,0.58,0.5455,0.2836,44,391,435
0,9,7,0.54,0.5152,0.19399999999999998,18,312,330
0,6,19,0.74,0.7121,0.2239,67,358,425
1,9,14,0.72,0.6515,0.2836,232,415,647
1,10,17,0.58,0.5455,0.3284,102,788,890
1,3,21,0.28,0.2727,0.2239,9,70,79
0,10,8,0.28,0.2576,0.3582,4,16,20
0,2,1,0.3,0.2424,0.7761,0,5,5
1,12,8,0.26,0.2879,0.0896,12,81,93
1,3,0,0.54,0.5152,0.19399999999999998,10,38,48
0,10,9,0.4,0.4091,0.0,48,95,143
1,9,4,0.5,0.4848,0.0,1,9,10
0,12,12,0.32,0.3333,0.1343,38,159,197
0,10,14,0.56,0.5303,0.2537,66,134,200
0,4,11,0.42,0.4242,0.19399999999999998,4,57,61
1,6,15,0.58,0.5455,0.1343,54,218,272
0,7,19,0.8,0.6970000000000001,0.2239,156,149,305
1,2,22,0.3,0.2879,0.2239,3,68,71
1,3,11,0.52,0.5,0.0,53,166,219
0,4,7,0.32,0.303,0.2239,13,20,33
0,3,20,0.28,0.2424,0.4179,3,8,11
1,2,17,0.38,0.3939,0.4478,21,411,432
1,8,9,0.66,0.6212,0.2836,81,211,292
0,6,10,0.74,0.6818,0.1642,91,173,264
1,1,8,0.1,0.1212,0.1642,3,75,78
0,1,10,0.22,0.2121,0.2836,2,26,28
0,3,20,0.3,0.303,0.1343,6,75,81
1,5,16,0.66,0.6212,0.19399999999999998,68,289,357
0,9,11,0.64,0.5758,0.19399999999999998,23,142,165
1,8,9,0.72,0.6818,0.19399999999999998,57,310,367
0,6,5,0.62,0.5758,0.1343,0,3,3
1,3,0,0.38,0.3939,0.19399999999999998,4,20,24
1,1,13,0.14,0.1212,0.2537,9,82,91
0,2,7,0.32,0.3333,0.1045,7,119,126
0,2,22,0.12,0.1061,0.3582,0,29,29
1,3,3,0.52,0.5,0.0896,0,7,7
0,11,23,0.4,0.4091,0.1642,23,78,101
0,8,21,0.76,0.6667,0.1045,47,162,209
0,10,20,0.6,0.5152,0.0896,5,140,145
0,3,9,0.26,0.2424,0.2537,6,126,132
1,8,17,0.74,0.6818,0.2239,72,711,783
1,5,11,0.62,0.6212,0.2985,45,156,201
0,7,5,0.68,0.6364,0.1045,4,19,23
1,12,3,0.38,0.3939,0.1045,0,4,4
0,12,5,0.22,0.2576,0.0896,0,10,10
1,2,0,0.36,0.3333,0.3881,5,56,61
1,7,0,0.72,0.6970000000000001,0.1045,11,32,43
1,4,0,0.44,0.4394,0.1045,6,11,17
0,4,15,0.5,0.4848,0.2239,156,141,297
1,2,7,0.28,0.2424,0.4478,3,20,23
0,4,18,0.32,0.303,0.2537,8,54,62
0,3,0,0.24,0.2273,0.2239,0,3,3
0,3,12,0.34,0.3333,0.1642,15,65,80
1,7,15,0.8,0.7121,0.2537,56,220,276
0,1,1,0.22,0.2273,0.19399999999999998,0,20,20
0,9,20,0.6,0.5606,0.2985,11,91,102
1,10,18,0.62,0.5455,0.0896,48,639,687
1,8,23,0.66,0.6212,0.0,19,137,156
1,4,17,0.54,0.5152,0.4179,299,268,567
1,12,22,0.26,0.2273,0.2985,6,57,63
0,2,4,0.46,0.4545,0.2537,0,1,1
0,6,12,0.72,0.6667,0.0,40,130,170
0,11,19,0.42,0.4242,0.0896,39,274,313
1,12,9,0.42,0.4242,0.2239,11,273,284
1,3,1,0.46,0.4545,0.3284,4,17,21
0,11,21,0.6,0.6212,0.3582,37,176,213
0,7,3,0.68,0.6364,0.1642,2,8,10
0,12,15,0.38,0.3939,0.0,100,237,337
0,10,22,0.36,0.3485,0.19399999999999998,8,77,85
0,8,7,0.7,0.6667,0.3582,2,26,28
1,10,8,0.46,0.4545,0.1343,29,164,193
1,11,10,0.34,0.3333,0.19399999999999998,73,287,360
1,8,23,0.72,0.6818,0.2836,33,159,192
0,12,19,0.3,0.3182,0.0896,16,49,65
1,7,18,0.82,0.7576,0.1642,100,522,622
0,10,8,0.52,0.5,0.0,26,441,467
0,11,11,0.46,0.4545,0.1045,16,101,117
1,11,1,0.28,0.303,0.0896,5,37,42
0,6,4,0.66,0.6061,0.1642,0,4,4
1,11,19,0.36,0.3485,0.1642,22,217,239
1,11,13,0.36,0.3333,0.2537,32,182,214
1,9,4,0.56,0.5303,0.2537,2,12,14
1,7,6,0.68,0.6364,0.1045,4,183,187
1,10,14,0.72,0.6818,0.1642,56,195,251
1,10,10,0.66,0.6061,0.1343,27,150,177
0,4,21,0.36,0.3485,0.1343,10,65,75
1,8,6,0.6,0.5758,0.1642,3,162,165
0,6,23,0.6,0.5606,0.2537,2,14,16
0,8,11,0.82,0.7424,0.3582,90,89,179
1,8,8,0.64,0.6061,0.2537,28,161,189
0,11,16,0.42,0.4242,0.2985,99,188,287
1,1,19,0.26,0.2273,0.2985,5,229,234
0,11,18,0.5,0.4848,0.2836,27,414,441
1,7,20,0.6,0.5455,0.1642,51,163,214
0,1,14,0.14,0.1364,0.2239,2,43,45
0,3,16,0.3,0.2879,0.2239,6,78,84
0,1,23,0.16,0.1515,0.2537,3,21,24
1,3,19,0.26,0.2576,0.2239,6,220,226
0,3,15,0.38,0.3939,0.1642,24,77,101
1,12,1,0.4,0.4091,0.1343,2,11,13
1,4,10,0.62,0.6061,0.2537,75,149,224
0,11,20,0.54,0.5152,0.2537,12,206,218
1,8,13,0.8,0.7424,0.2239,85,204,289
1,4,19,0.6,0.6061,0.3881,89,187,276
1,3,12,0.44,0.4394,0.3881,40,175,215
1,4,21,0.52,0.5,0.1343,27,212,239
0,11,2,0.4,0.4091,0.0,2,8,10
0,8,23,0.74,0.6515,0.0896,14,94,108
0,12,23,0.26,0.303,0.0,4,55,59
0,4,1,0.62,0.5909,0.2836,16,5,21
0,2,0,0.2,0.1667,0.4478,1,11,12
1,12,10,0.28,0.2727,0.1642,45,211,256
0,12,9,0.3,0.3333,0.0,9,230,239
1,7,21,0.78,0.7424,0.1045,71,189,260
0,2,0,0.38,0.3939,0.3582,3,8,11
1,7,1,0.74,0.6970000000000001,0.1343,12,81,93
1,5,19,0.7,0.6515,0.2836,91,499,590
0,6,8,0.6,0.5909,0.2537,24,74,98
0,3,3,0.2,0.19699999999999998,0.2239,0,14,14
1,2,16,0.4,0.4091,0.2239,5,162,167
1,4,20,0.46,0.4545,0.3881,34,248,282
0,3,12,0.44,0.4394,0.2537,25,56,81
1,10,22,0.36,0.3485,0.1343,18,147,165
0,9,18,0.64,0.5606,0.3582,2,66,68
0,7,8,0.78,0.7424,0.2239,27,87,114
0,2,6,0.1,0.1818,0.0,1,23,24
1,4,17,0.56,0.5303,0.5224,88,656,744
1,12,4,0.36,0.3788,0.0,2,3,5
0,11,4,0.38,0.3939,0.0896,1,6,7
1,1,17,0.26,0.2273,0.3881,17,136,153
1,6,18,0.72,0.6515,0.2239,256,315,571
0,3,20,0.32,0.3333,0.0896,2,74,76
1,12,4,0.5,0.4848,0.4478,1,9,10
1,9,7,0.46,0.4545,0.2239,9,48,57
1,8,2,0.64,0.5758,0.2239,12,104,116
1,12,1,0.34,0.3485,0.1045,14,82,96
0,8,12,0.74,0.6818,0.0896,54,168,222
0,1,2,0.16,0.2273,0.0,1,10,11
1,10,15,0.56,0.5303,0.3284,240,383,623
1,1,23,0.36,0.3788,0.0,13,88,101
0,2,15,0.36,0.3333,0.2836,40,125,165
1,3,16,0.5,0.4848,0.3582,208,301,509
0,8,3,0.62,0.5909,0.0,9,42,51
0,6,19,0.7,0.6667,0.1045,67,156,223
1,5,14,0.7,0.6515,0.1343,228,324,552
0,11,4,0.32,0.3485,0.0,0,4,4
1,8,12,0.76,0.6667,0.19399999999999998,266,388,654
1,6,8,0.62,0.6061,0.1045,42,202,244
0,5,0,0.68,0.6364,0.2537,14,55,69
0,1,21,0.16,0.2273,0.0,4,48,52
0,9,11,0.62,0.5758,0.0896,118,268,386
1,6,12,0.62,0.6212,0.0,80,235,315
1,12,15,0.34,0.3333,0.1343,39,98,137
0,1,22,0.14,0.1212,0.2537,0,13,13
1,9,5,0.42,0.4242,0.0896,1,46,47
0,7,18,0.76,0.7121,0.19399999999999998,77,486,563
1,10,18,0.52,0.5,0.19399999999999998,71,342,413
1,6,5,0.6,0.5606,0.19399999999999998,2,38,40
1,8,6,0.7,0.6667,0.19399999999999998,3,176,179
0,12,22,0.5,0.4848,0.2537,3,102,105
0,4,16,0.38,0.3939,0.3284,111,85,196
0,5,4,0.52,0.5,0.2985,1,2,3
0,10,9,0.46,0.4545,0.19399999999999998,20,188,208
1,9,14,0.74,0.6970000000000001,0.2985,163,349,512
1,5,17,0.64,0.6212,0.1343,76,629,705
0,8,12,0.8,0.6970000000000001,0.0,55,167,222
1,3,20,0.62,0.5909,0.2836,64,360,424
0,9,17,0.76,0.7273,0.2239,204,172,376
1,7,5,0.7,0.6515,0.0,2,33,35
0,10,2,0.34,0.3485,0.0896,10,40,50
0,10,16,0.58,0.5455,0.3284,36,273,309
0,5,5,0.54,0.5152,0.0,0,11,11
1,12,22,0.26,0.2727,0.1343,13,48,61
1,6,17,0.82,0.7424,0.2836,184,337,521
1,2,13,0.36,0.3636,0.1045,16,174,190
0,8,7,0.62,0.5758,0.3582,0,1,1
0,11,23,0.36,0.3636,0.0896,1,47,48
0,2,10,0.3,0.2727,0.3284,19,86,105
1,10,7,0.4,0.4091,0.0,6,59,65
1,8,6,0.64,0.5758,0.19399999999999998,1,63,64
1,6,7,0.64,0.5758,0.1642,10,82,92
1,2,2,0.3,0.3182,0.1045,1,11,12
1,12,8,0.24,0.2424,0.1343,1,238,239
1,10,17,0.56,0.5303,0.2836,248,370,618
1,2,15,0.32,0.2879,0.4179,21,211,232
0,8,20,0.66,0.6212,0.1343,45,240,285
1,9,7,0.52,0.5,0.0,35,468,503
0,4,1,0.26,0.2727,0.1343,4,28,32
0,11,17,0.34,0.303,0.3284,24,286,310
1,1,22,0.46,0.4545,0.3881,5,85,90
0,10,10,0.36,0.3485,0.1642,18,87,105
0,10,22,0.22,0.2121,0.2239,10,44,54
0,10,6,0.38,0.3939,0.1642,3,7,10
0,6,20,0.7,0.6515,0.19399999999999998,86,146,232
1,11,6,0.24,0.2273,0.19399999999999998,4,142,146
1,11,7,0.3,0.303,0.1343,4,289,293
1,3,15,0.42,0.4242,0.0,73,207,280
0,11,8,0.4,0.4091,0.3582,8,387,395
0,2,2,0.24,0.19699999999999998,0.5522,0,17,17
1,11,21,0.26,0.2727,0.1343,7,201,208
1,10,11,0.56,0.5303,0.1642,68,222,290
0,8,21,0.76,0.7121,0.0896,30,156,186
1,5,18,0.66,0.6212,0.19399999999999998,164,382,546
1,9,8,0.48,0.4697,0.19399999999999998,41,764,805
0,7,13,0.84,0.8182,0.19399999999999998,23,97,120
0,11,16,0.4,0.4091,0.2239,128,207,335
0,5,1,0.46,0.4545,0.2239,1,16,17
1,9,23,0.56,0.5303,0.19399999999999998,26,164,190
1,5,0,0.58,0.5455,0.19399999999999998,8,27,35
0,9,14,0.58,0.5455,0.19399999999999998,27,85,112
1,9,11,0.74,0.6970000000000001,0.0,226,263,489
1,3,23,0.28,0.2727,0.2239,3,51,54
0,9,8,0.64,0.5758,0.1045,27,400,427
1,6,12,0.72,0.6515,0.3284,89,280,369
0,10,21,0.54,0.5152,0.1343,28,178,206
0,12,19,0.34,0.3333,0.19399999999999998,1,75,76
0,7,20,0.7,0.6364,0.2239,81,267,348
1,10,23,0.36,0.3485,0.1343,12,68,80
0,1,12,0.22,0.1818,0.5821,11,67,78
1,9,18,0.64,0.6212,0.1642,110,767,877
0,10,15,0.48,0.4697,0.2239,159,223,382
1,12,21,0.2,0.2121,0.1642,5,42,47
0,3,21,0.32,0.3333,0.1343,6,55,61
1,9,9,0.56,0.5303,0.0896,25,330,355
1,7,22,0.72,0.6970000000000001,0.1045,34,96,130
1,1,20,0.26,0.2576,0.1642,8,161,169
1,11,6,0.3,0.2879,0.2836,4,135,139
1,9,3,0.7,0.6667,0.1045,0,9,9
0,1,5,0.2,0.1818,0.2836,0,1,1
1,1,0,0.36,0.3788,0.0,5,43,48
0,9,20,0.66,0.6212,0.2239,33,247,280
0,6,23,0.56,0.5303,0.2239,19,91,110
0,1,6,0.16,0.1667,0.1642,0,2,2
1,1,5,0.3,0.3182,0.0896,0,26,26
1,10,12,0.48,0.4697,0.19399999999999998,43,217,260
0,7,22,0.7,0.6515,0.2836,65,136,201
0,7,7,0.74,0.7273,0.1343,23,251,274
0,3,4,0.34,0.3333,0.1642,4,9,13
1,12,20,0.38,0.3939,0.1045,12,229,241
0,8,19,0.84,0.7727,0.2537,53,393,446
1,8,5,0.7,0.6667,0.19399999999999998,2,23,25
1,5,8,0.5,0.4848,0.1343,23,91,114
1,9,21,0.62,0.5758,0.2239,28,205,233
0,9,18,0.64,0.5758,0.1045,50,501,551
0,10,8,0.46,0.4545,0.2836,24,101,125
1,6,13,0.9,0.8182,0.0,31,141,172
1,1,7,0.12,0.1667,0.0896,2,204,206
1,10,13,0.5,0.4848,0.1343,54,184,238
0,6,9,0.72,0.6515,0.3881,32,189,221
0,3,6,0.24,0.2121,0.2985,2,34,36
1,8,19,0.64,0.5909,0.2985,97,257,354
1,11,11,0.4,0.4091,0.1045,143,323,466
1,3,5,0.46,0.4545,0.0,2,24,26
0,10,5,0.32,0.3485,0.0,1,2,3
1,2,0,0.24,0.2121,0.3582,7,63,70
0,10,4,0.34,0.3636,0.0,5,1,6
0,2,15,0.2,0.19699999999999998,0.2537,0,50,50
1,4,9,0.42,0.4242,0.1343,59,206,265
1,4,8,0.34,0.3182,0.2537,12,599,611
1,3,4,0.2,0.2273,0.0896,0,1,1
0,12,21,0.2,0.2121,0.1642,8,88,96
1,2,17,0.4,0.4091,0.0896,30,458,488
0,6,16,0.86,0.8029999999999999,0.2985,39,227,266
0,3,17,0.34,0.303,0.2985,25,227,252
0,6,2,0.6,0.5455,0.0,16,37,53
0,2,3,0.26,0.2879,0.0896,3,10,13
0,10,19,0.52,0.5,0.2239,35,310,345
0,9,20,0.6,0.5152,0.0,21,158,179
0,10,19,0.44,0.4394,0.3881,25,228,253
1,12,2,0.26,0.303,0.0,3,47,50
1,11,9,0.32,0.3333,0.0,56,161,217
1,3,17,0.56,0.5303,0.2985,49,551,600
1,6,3,0.66,0.6212,0.0896,19,41,60
0,12,19,0.34,0.3636,0.0,10,189,199
0,10,14,0.74,0.6515,0.0,147,223,370
0,1,4,0.02,0.0606,0.1343,0,1,1
1,7,0,0.76,0.7273,0.0,27,122,149
0,9,9,0.66,0.6212,0.2537,83,118,201
0,11,12,0.36,0.3333,0.2836,12,148,160
1,12,21,0.34,0.3333,0.1642,1,25,26
1,1,3,0.18,0.2424,0.0,0,1,1
0,1,11,0.16,0.1212,0.5224,2,47,49
0,9,11,0.7,0.6515,0.19399999999999998,34,131,165
1,7,13,0.8,0.7576,0.2836,69,219,288
1,1,12,0.2,0.19699999999999998,0.19399999999999998,5,106,111
0,10,16,0.42,0.4242,0.1343,107,213,320
1,10,22,0.4,0.4091,0.2985,17,143,160
1,3,0,0.22,0.2121,0.2985,0,8,8
0,3,16,0.54,0.5152,0.3284,27,112,139
1,4,5,0.3,0.2879,0.19399999999999998,0,22,22
1,10,0,0.44,0.4394,0.1642,28,99,127
1,2,13,0.3,0.3182,0.0896,22,170,192
1,2,2,0.26,0.2273,0.2985,0,4,4
1,9,17,0.6,0.6212,0.3582,256,456,712
1,7,16,0.74,0.6970000000000001,0.2537,34,190,224
1,7,1,0.64,0.5758,0.0,3,11,14
1,3,13,0.46,0.4545,0.1642,198,346,544
0,12,4,0.18,0.2424,0.0,0,3,3
1,5,5,0.56,0.5303,0.2239,0,8,8
1,7,2,0.72,0.6818,0.0,14,76,90
1,5,15,0.72,0.6667,0.1343,54,221,275
1,3,2,0.26,0.2273,0.2985,1,6,7
0,5,7,0.46,0.4545,0.1343,14,283,297
0,7,7,0.72,0.6818,0.2836,30,288,318
0,4,3,0.3,0.3333,0.0,3,8,11
1,12,13,0.36,0.3485,0.2239,39,274,313
1,4,20,0.64,0.6212,0.2239,39,333,372
1,6,16,0.9,0.8182,0.1343,37,283,320
1,6,10,0.84,0.7879,0.1045,36,114,150
0,7,7,0.62,0.5909,0.1343,14,38,52
0,3,12,0.4,0.4091,0.19399999999999998,20,62,82
0,6,18,0.74,0.6667,0.0,79,512,591
1,3,4,0.48,0.4697,0.0896,1,4,5
0,9,7,0.46,0.4545,0.2239,15,29,44
1,10,21,0.5,0.4848,0.0,17,189,206
1,9,15,0.68,0.6364,0.2836,312,342,654
1,12,16,0.3,0.2727,0.4478,23,124,147
1,5,17,0.74,0.6515,0.0896,279,347,626
1,12,11,0.22,0.2273,0.19399999999999998,43,114,157
1,1,2,0.28,0.2727,0.2537,0,12,12
0,1,3,0.14,0.1212,0.3284,0,3,3
1,11,3,0.26,0.2576,0.2239,0,3,3
1,9,0,0.7,0.6667,0.0896,30,35,65
1,11,7,0.28,0.2576,0.3881,12,411,423
0,2,13,0.34,0.3182,0.2537,38,136,174
1,10,7,0.52,0.5,0.19399999999999998,18,477,495
1,9,17,0.66,0.6212,0.2537,295,434,729
0,3,9,0.22,0.2273,0.1343,17,37,54
0,1,8,0.16,0.2273,0.0,3,216,219
1,1,15,0.44,0.4394,0.4925,6,123,129
1,2,21,0.14,0.0758,0.6418,5,43,48
1,1,7,0.2,0.2273,0.0896,3,212,215
0,9,22,0.6,0.5455,0.5821,15,49,64
1,10,10,0.5,0.4848,0.2836,65,157,222
1,3,11,0.38,0.3939,0.19399999999999998,40,154,194
0,2,14,0.4,0.4091,0.2985,2,67,69
1,5,20,0.74,0.6818,0.1642,168,224,392
0,12,22,0.34,0.3333,0.1642,7,78,85
1,5,4,0.6,0.5758,0.1343,2,4,6
1,10,8,0.58,0.5455,0.0,36,749,785
0,3,17,0.3,0.2879,0.2239,12,221,233
1,11,1,0.34,0.3485,0.1045,3,10,13
0,7,14,0.84,0.7424,0.1343,158,215,373
0,3,18,0.3,0.2879,0.2537,8,190,198
0,6,0,0.62,0.6212,0.2836,15,53,68
0,4,5,0.36,0.3485,0.1642,2,1,3
1,1,4,0.16,0.1364,0.2836,1,1,2
0,2,9,0.4,0.4091,0.3881,8,122,130
1,7,4,0.64,0.6061,0.2239,0,4,4
1,2,0,0.28,0.303,0.0896,4,39,43
0,4,3,0.54,0.5152,0.2836,17,4,21
0,8,15,0.8,0.7424,0.1045,66,156,222
1,11,22,0.42,0.4242,0.19399999999999998,21,113,134
0,11,16,0.36,0.3485,0.2239,6,67,73
0,3,15,0.34,0.3636,0.0,7,57,64
1,4,16,0.52,0.5,0.2537,236,275,511
1,8,10,0.74,0.6667,0.1343,78,121,199
1,5,3,0.56,0.5303,0.0896,0,6,6
0,5,5,0.44,0.4394,0.0,0,5,5
0,10,18,0.44,0.4394,0.2537,43,354,397
0,7,11,0.74,0.7121,0.2537,61,104,165
0,11,16,0.52,0.5,0.1343,31,240,271
1,10,21,0.6,0.5909,0.2239,47,220,267
0,10,23,0.5,0.4848,0.0,23,113,136
1,11,23,0.32,0.3182,0.1642,7,118,125
0,5,1,0.4,0.4091,0.1642,8,24,32
1,10,6,0.36,0.3485,0.1642,1,158,159
0,2,18,0.28,0.2424,0.4478,2,81,83
0,12,16,0.5,0.4848,0.0896,10,238,248
1,1,13,0.22,0.2121,0.2836,38,182,220
1,2,23,0.32,0.3333,0.1343,2,49,51
0,8,18,0.84,0.7576,0.1343,64,465,529
0,2,12,0.18,0.1818,0.2239,4,57,61
1,9,19,0.7,0.6515,0.19399999999999998,99,308,407
1,10,6,0.56,0.5303,0.2985,6,141,147
1,10,23,0.52,0.5,0.3881,31,136,167
1,6,22,0.74,0.6515,0.1045,101,178,279
0,8,22,0.68,0.6364,0.0,74,157,231
1,12,2,0.26,0.2576,0.1642,0,7,7
0,5,10,0.58,0.5455,0.2239,73,153,226
1,12,17,0.32,0.3333,0.1045,43,507,550
1,5,3,0.5,0.4848,0.0,1,2,3
1,12,18,0.42,0.4242,0.4478,29,580,609
0,4,6,0.34,0.3485,0.1045,4,66,70
0,11,16,0.48,0.4697,0.1642,46,252,298
0,2,8,0.32,0.3333,0.0896,18,267,285
1,7,21,0.74,0.6818,0.0896,33,298,331
0,5,18,0.42,0.4242,0.2537,29,367,396
0,10,0,0.44,0.4394,0.0,19,48,67
1,7,3,0.74,0.7121,0.1343,12,19,31
0,1,5,0.08,0.0909,0.19399999999999998,0,1,1
1,5,9,0.56,0.5303,0.1045,57,304,361
0,7,22,0.82,0.8636,0.1642,36,113,149
1,1,11,0.26,0.2576,0.0,6,93,99
0,10,7,0.42,0.4242,0.0896,27,46,73
1,5,0,0.68,0.6364,0.1642,48,89,137
0,7,6,0.7,0.6515,0.2239,4,119,123
0,6,23,0.74,0.6970000000000001,0.1642,15,82,97
1,11,21,0.3,0.3333,0.0,5,208,213
0,11,7,0.3,0.3333,0.0,0,300,300
1,2,3,0.24,0.2273,0.19399999999999998,0,8,8
1,10,14,0.6,0.5758,0.2836,57,128,185
0,7,3,0.66,0.6061,0.19399999999999998,3,4,7
0,12,10,0.26,0.2424,0.2836,10,171,181
1,11,0,0.26,0.2424,0.2836,4,20,24
0,3,23,0.46,0.4545,0.0896,8,22,30
0,5,5,0.4,0.4091,0.0896,0,10,10
1,2,2,0.24,0.2576,0.0896,1,19,20
0,8,18,0.82,0.7121,0.2985,70,489,559
1,10,5,0.62,0.5455,0.1045,2,32,34
1,10,10,0.54,0.5152,0.1045,41,156,197
1,8,2,0.64,0.6061,0.1045,1,8,9
1,6,2,0.56,0.5303,0.2239,1,10,11
0,4,2,0.6,0.6212,0.1343,7,7,14
1,11,20,0.24,0.2121,0.2836,3,55,58
0,7,22,0.66,0.6061,0.1045,69,93,162
1,11,0,0.34,0.3333,0.1642,9,99,108
0,6,3,0.64,0.6212,0.19399999999999998,18,21,39
0,6,4,0.58,0.5455,0.1343,2,4,6
1,2,3,0.34,0.3182,0.2239,1,3,4
0,11,15,0.36,0.3333,0.4179,29,187,216
1,12,5,0.4,0.4091,0.1045,0,8,8
1,5,22,0.6,0.5758,0.2537,13,134,147
1,8,14,0.82,0.7121,0.0,72,176,248
0,10,3,0.46,0.4545,0.0,1,3,4
1,8,3,0.62,0.5909,0.0896,11,37,48
0,8,21,0.7,0.6515,0.19399999999999998,54,119,173
1,7,19,0.64,0.5758,0.2836,44,358,402
0,3,17,0.3,0.2879,0.2537,15,153,168
0,1,3,0.2,0.2273,0.1045,1,0,1
0,2,3,0.2,0.2576,0.0,0,1,1
1,12,22,0.34,0.3485,0.0896,12,117,129
0,9,21,0.56,0.5303,0.0,29,177,206
0,1,7,0.16,0.1818,0.1045,1,8,9
0,9,0,0.42,0.4242,0.2239,5,43,48
1,6,6,0.62,0.5909,0.0,3,27,30
0,4,6,0.24,0.2576,0.1045,4,52,56
1,7,13,0.86,0.7576,0.2239,74,162,236
1,2,2,0.24,0.2576,0.1045,4,59,63
1,3,9,0.52,0.5,0.0896,75,305,380
0,4,21,0.62,0.5606,0.2836,19,126,145
1,1,18,0.4,0.4091,0.1045,13,372,385
1,4,21,0.52,0.5,0.2239,53,77,130
1,7,19,0.82,0.7727,0.19399999999999998,93,423,516
1,9,12,0.74,0.6970000000000001,0.0,248,297,545
0,2,2,0.44,0.4394,0.2836,2,5,7
0,7,13,0.76,0.6818,0.2985,221,276,497
1,3,15,0.52,0.5,0.2836,275,330,605
0,1,20,0.26,0.2727,0.1045,3,30,33
0,6,16,0.92,0.8788,0.2239,34,199,233
0,7,22,0.76,0.6970000000000001,0.1343,27,131,158
1,2,16,0.36,0.3333,0.2537,64,275,339
0,6,16,0.72,0.6364,0.3284,63,286,349
0,4,10,0.66,0.6212,0.3582,22,98,120
1,1,8,0.2,0.2273,0.0896,9,82,91
1,3,9,0.22,0.2727,0.0,11,222,233
0,3,11,0.42,0.4242,0.2985,32,47,79
1,6,20,0.72,0.6515,0.1343,117,291,408
0,8,19,0.74,0.6667,0.19399999999999998,56,320,376
0,11,0,0.4,0.4091,0.19399999999999998,12,61,73
1,7,18,0.78,0.6970000000000001,0.19399999999999998,108,523,631
0,5,14,0.62,0.5909,0.4627,61,123,184
1,8,12,0.76,0.6818,0.0896,95,276,371
0,11,23,0.3,0.3182,0.0896,6,67,73
0,11,7,0.52,0.5,0.2239,12,330,342
0,1,15,0.28,0.2727,0.0,8,54,62
1,1,5,0.14,0.1515,0.1343,0,4,4
1,4,11,0.54,0.5152,0.1642,64,190,254
0,1,14,0.36,0.3485,0.19399999999999998,4,55,59
1,5,23,0.58,0.5455,0.1045,11,64,75
0,9,5,0.56,0.5303,0.1343,1,15,16
0,8,7,0.68,0.6364,0.3284,17,296,313
1,2,3,0.42,0.4242,0.1343,0,5,5
1,8,11,0.68,0.6364,0.1343,73,178,251
1,3,6,0.32,0.3333,0.1343,5,81,86
0,2,17,0.24,0.2121,0.2836,14,64,78
0,5,12,0.52,0.5,0.3582,27,169,196
0,1,20,0.1,0.1061,0.2537,4,31,35
0,11,19,0.3,0.2879,0.2239,7,210,217
1,4,8,0.6,0.6212,0.2239,42,631,673
1,3,9,0.42,0.4242,0.0896,65,113,178
0,6,17,0.7,0.6515,0.0,81,484,565
0,1,8,0.4,0.4091,0.2239,0,8,8
0,11,18,0.3,0.303,0.1642,16,312,328
1,9,14,0.74,0.7121,0.0896,38,178,216
1,1,4,0.32,0.303,0.2537,2,4,6
0,12,2,0.22,0.2576,0.0896,0,2,2
1,12,10,0.32,0.3333,0.1045,17,147,164
1,10,15,0.6,0.5758,0.3284,70,190,260
0,10,18,0.64,0.6212,0.0,108,365,473
0,7,13,0.86,0.8029999999999999,0.2537,26,126,152
0,9,0,0.6,0.5152,0.1045,11,30,41
0,6,12,0.7,0.6667,0.1642,40,149,189
0,9,20,0.52,0.5,0.1343,43,133,176
0,7,13,0.8,0.6818,0.0,83,209,292
0,7,14,0.84,0.7121,0.0,177,215,392
0,10,20,0.52,0.5,0.1045,40,189,229
0,7,19,0.74,0.6818,0.19399999999999998,164,242,406
0,8,14,0.72,0.6970000000000001,0.0,27,86,113
1,10,19,0.5,0.4848,0.19399999999999998,6,109,115
1,6,11,0.8,0.7424,0.1642,76,160,236
1,10,15,0.7,0.6364,0.1045,63,245,308
1,4,0,0.48,0.4697,0.1045,5,59,64
0,12,14,0.48,0.4697,0.3582,11,40,51
1,11,2,0.32,0.3485,0.0,2,42,44
1,4,15,0.52,0.5,0.4179,321,305,626
0,12,12,0.48,0.4697,0.0,22,180,202
0,9,18,0.64,0.5909,0.1045,157,243,400
0,10,6,0.44,0.4394,0.1045,5,112,117
1,1,1,0.14,0.1515,0.1642,0,5,5
1,2,14,0.46,0.4545,0.1045,5,26,31
1,5,9,0.48,0.4697,0.2985,34,288,322
0,1,20,0.2,0.2121,0.1642,3,66,69
0,5,8,0.5,0.4848,0.1045,28,397,425
1,10,4,0.42,0.4242,0.2836,2,10,12
1,3,13,0.42,0.4242,0.2985,176,288,464
0,12,23,0.36,0.3485,0.1642,10,50,60
0,5,2,0.62,0.5606,0.1045,12,49,61
1,8,13,0.8,0.7273,0.0896,83,203,286
0,2,17,0.42,0.4242,0.19399999999999998,66,121,187
0,6,23,0.64,0.6212,0.0,29,121,150
1,5,4,0.44,0.4394,0.1045,3,6,9
1,7,4,0.6,0.5455,0.0,6,10,16
1,7,3,0.7,0.6667,0.19399999999999998,0,5,5
1,4,12,0.38,0.3939,0.0,105,276,381
1,4,19,0.4,0.4091,0.3582,28,356,384
0,4,2,0.46,0.4545,0.2836,8,5,13
1,4,9,0.38,0.3939,0.3582,52,265,317
0,4,22,0.32,0.303,0.2985,3,43,46
1,10,15,0.62,0.6212,0.1343,95,234,329
1,3,18,0.5,0.4848,0.2985,83,598,681
0,9,7,0.6,0.5455,0.0896,3,83,86
1,7,17,0.86,0.7879,0.0,93,678,771
0,10,11,0.56,0.5303,0.0,80,150,230
1,12,8,0.38,0.3939,0.0896,5,106,111
1,12,5,0.26,0.303,0.0,0,3,3
1,5,2,0.46,0.4545,0.1642,15,16,31
1,11,16,0.44,0.4394,0.0,49,297,346
1,2,12,0.36,0.3485,0.1343,19,164,183
0,9,10,0.62,0.5152,0.1045,7,28,35
0,9,15,0.64,0.6212,0.2836,52,193,245
0,7,5,0.66,0.6212,0.1343,5,21,26
0,10,13,0.4,0.4091,0.3284,27,98,125
1,12,17,0.34,0.3485,0.1045,50,270,320
0,3,14,0.5,0.4848,0.3284,30,71,101
1,12,22,0.24,0.2424,0.1642,2,131,133
0,8,15,0.84,0.8029999999999999,0.2537,130,232,362
0,5,14,0.76,0.6970000000000001,0.2537,51,188,239
1,8,10,0.74,0.6818,0.0896,76,157,233
1,12,18,0.26,0.2727,0.1343,10,112,122
0,1,10,0.36,0.3485,0.2239,7,46,53
0,9,0,0.54,0.5152,0.2239,1,12,13
0,12,5,0.22,0.2727,0.0,0,20,20
1,6,7,0.48,0.4697,0.2985,29,540,569
0,2,9,0.22,0.2121,0.2836,7,48,55
0,4,2,0.38,0.3939,0.0896,12,24,36
1,6,21,0.64,0.6061,0.1642,67,270,337
0,8,17,0.76,0.6970000000000001,0.3582,83,484,567
0,8,5,0.66,0.6212,0.3582,1,23,24
0,3,14,0.24,0.2576,0.1045,18,60,78
0,9,19,0.74,0.6970000000000001,0.19399999999999998,178,150,328
0,8,13,0.86,0.7424,0.2239,50,153,203
0,3,19,0.44,0.4394,0.5821,5,51,56
1,6,20,0.62,0.6212,0.2836,139,260,399
0,1,11,0.16,0.1515,0.19399999999999998,2,46,48
1,8,14,0.9,0.8485,0.4627,161,365,526
1,6,11,0.64,0.6212,0.4179,46,189,235
1,8,15,0.64,0.6061,0.3284,79,154,233
1,1,17,0.36,0.3485,0.1642,27,443,470
0,12,13,0.46,0.4545,0.0,21,167,188
1,6,8,0.66,0.6212,0.1343,40,577,617
0,4,23,0.3,0.3182,0.0896,12,41,53
1,6,0,0.66,0.5909,0.19399999999999998,7,27,34
0,5,11,0.54,0.5152,0.3284,42,123,165
0,2,21,0.14,0.1061,0.4627,8,46,54
0,3,17,0.7,0.6364,0.3284,95,237,332
1,2,0,0.3,0.2879,0.19399999999999998,1,22,23
0,2,9,0.12,0.1061,0.3582,1,121,122
0,4,18,0.72,0.6364,0.4925,78,308,386
0,3,21,0.3,0.2879,0.19399999999999998,7,68,75
1,4,14,0.5,0.4848,0.2985,326,252,578
1,9,7,0.56,0.5303,0.0,10,384,394
1,4,6,0.3,0.2727,0.2985,2,43,45
0,9,13,0.66,0.6212,0.1642,37,144,181
0,11,8,0.32,0.3333,0.0896,10,50,60
0,11,22,0.52,0.5,0.1045,7,102,109
0,9,6,0.62,0.5455,0.0896,5,99,104
0,9,13,0.6,0.5,0.0896,7,27,34
0,10,7,0.42,0.4242,0.0,5,237,242
1,3,4,0.52,0.5,0.0896,1,6,7
0,7,7,0.7,0.6667,0.19399999999999998,30,302,332
1,10,3,0.42,0.4242,0.2985,3,25,28
1,5,5,0.56,0.5303,0.3284,1,34,35
1,1,6,0.26,0.2576,0.2239,2,71,73
0,2,23,0.2,0.1667,0.4179,0,2,2
1,3,21,0.44,0.4394,0.0,8,144,152
0,8,3,0.66,0.5909,0.0,1,0,1
0,3,11,0.34,0.3485,0.1045,92,111,203
0,1,9,0.2,0.1818,0.2985,9,125,134
0,12,7,0.38,0.3939,0.2239,4,88,92
0,6,16,0.72,0.6515,0.1343,168,272,440
1,5,12,0.64,0.6212,0.2239,189,342,531
0,8,4,0.7,0.6515,0.1343,1,4,5
0,10,11,0.36,0.3485,0.2239,40,128,168
0,11,2,0.24,0.2424,0.1642,12,34,46
0,10,12,0.4,0.4091,0.1343,29,118,147
1,9,1,0.6,0.5758,0.0896,5,16,21
1,11,17,0.48,0.4697,0.0896,117,183,300
1,8,0,0.7,0.6667,0.0,12,46,58
1,6,9,0.64,0.6061,0.5821,54,298,352
0,6,6,0.72,0.6970000000000001,0.1642,8,92,100
1,4,19,0.6,0.6061,0.2537,73,464,537
0,6,12,0.82,0.7576,0.0,176,244,420
0,7,19,0.86,0.9242,0.2836,51,233,284
1,11,4,0.3,0.2879,0.2836,1,9,10
1,2,20,0.38,0.3939,0.1343,6,178,184
0,3,0,0.34,0.303,0.4179,7,33,40
0,1,17,0.3,0.3182,0.1045,8,207,215
0,9,0,0.62,0.5455,0.0,32,84,116
0,1,11,0.18,0.2121,0.1045,0,30,30
0,7,22,0.72,0.6667,0.1642,78,123,201
1,2,0,0.34,0.303,0.3582,9,65,74
1,10,16,0.56,0.5303,0.19399999999999998,70,396,466
1,9,22,0.66,0.5909,0.0,21,57,78
1,5,13,0.64,0.6061,0.0,71,207,278
0,6,13,0.66,0.6212,0.1045,154,213,367
0,2,10,0.32,0.303,0.2537,29,52,81
0,10,9,0.56,0.5303,0.1045,3,106,109
1,4,2,0.46,0.4545,0.0,0,5,5
1,1,12,0.26,0.2727,0.1045,10,93,103
1,8,14,0.76,0.6818,0.0896,87,214,301
0,12,19,0.34,0.3333,0.1642,3,87,90
1,11,21,0.34,0.3485,0.0896,7,39,46
0,11,20,0.36,0.3333,0.3881,1,67,68
1,6,7,0.62,0.6061,0.1045,24,484,508
0,6,9,0.72,0.6515,0.2537,47,139,186
0,6,6,0.66,0.6061,0.0,12,110,122
1,8,6,0.6,0.5758,0.1343,6,155,161
0,4,16,0.6,0.5909,0.2836,180,246,426
1,9,2,0.52,0.5,0.2537,18,77,95
1,12,12,0.34,0.3333,0.1642,111,409,520
1,9,18,0.6,0.6212,0.2537,119,781,900
1,8,8,0.72,0.6970000000000001,0.1045,21,718,739
0,2,10,0.26,0.2424,0.2836,8,49,57
1,11,0,0.24,0.2576,0.1045,1,18,19
1,10,12,0.52,0.5,0.3284,69,256,325
1,3,8,0.42,0.4242,0.1045,25,71,96
0,9,1,0.56,0.5303,0.0,1,11,12
0,2,23,0.24,0.2879,0.0,4,26,30
1,2,21,0.34,0.3485,0.1045,20,170,190
0,8,5,0.54,0.5152,0.19399999999999998,1,35,36
0,8,5,0.52,0.5,0.0896,1,27,28
0,5,11,0.74,0.6667,0.0896,36,104,140
0,4,15,0.56,0.5303,0.1343,217,282,499
0,9,20,0.56,0.5303,0.1343,27,204,231
1,1,3,0.14,0.1818,0.0896,0,13,13
1,6,2,0.54,0.5152,0.0,3,38,41
0,11,21,0.32,0.2879,0.3881,7,128,135
1,3,3,0.18,0.1667,0.2836,0,1,1
0,1,11,0.16,0.1364,0.2836,2,28,30
0,10,21,0.5,0.4848,0.1045,36,141,177
0,7,4,0.62,0.6212,0.0,1,5,6
0,3,6,0.26,0.2424,0.2836,1,31,32
1,5,0,0.6,0.6212,0.2537,21,14,35
1,11,21,0.46,0.4545,0.2537,23,75,98
0,4,19,0.52,0.5,0.4179,9,62,71
1,5,15,0.62,0.6061,0.1045,229,342,571
0,7,19,0.76,0.7424,0.19399999999999998,54,334,388
0,12,17,0.3,0.303,0.1642,14,226,240
1,6,21,0.58,0.5455,0.2537,40,225,265
1,12,4,0.22,0.2121,0.2985,1,8,9
1,7,4,0.64,0.6061,0.1045,0,5,5
1,2,8,0.24,0.2879,0.0,3,510,513
1,11,14,0.44,0.4394,0.2537,47,170,217
0,10,21,0.24,0.2121,0.3582,1,49,50
1,9,8,0.68,0.6364,0.0896,30,99,129
0,2,8,0.22,0.2273,0.19399999999999998,1,11,12
0,1,11,0.18,0.19699999999999998,0.1343,4,60,64
0,5,19,0.58,0.5455,0.0896,49,253,302
1,12,6,0.24,0.2424,0.1343,7,20,27
0,6,5,0.6,0.6061,0.19399999999999998,7,18,25
1,2,1,0.22,0.2576,0.0896,0,6,6
0,11,22,0.36,0.3788,0.0,5,40,45
0,11,19,0.5,0.4848,0.3582,36,121,157
1,1,20,0.32,0.3485,0.0,18,211,229
1,12,12,0.36,0.3333,0.2537,30,252,282
1,7,12,0.84,0.8182,0.2537,73,206,279
1,7,9,0.76,0.7121,0.1642,51,297,348
0,1,10,0.18,0.19699999999999998,0.1642,2,57,59
0,3,11,0.34,0.303,0.3881,18,63,81
0,3,6,0.18,0.1667,0.2836,0,40,40
0,1,7,0.14,0.1515,0.1343,0,54,54
1,4,6,0.3,0.3182,0.0896,2,98,100
0,6,7,0.56,0.5303,0.19399999999999998,0,46,46
1,5,5,0.42,0.4242,0.1642,3,23,26
0,12,4,0.16,0.1818,0.1343,0,4,4
0,7,9,0.7,0.6667,0.19399999999999998,31,158,189
1,10,3,0.5,0.4848,0.1642,5,21,26
1,8,8,0.66,0.6212,0.0896,45,662,707
0,12,23,0.4,0.4091,0.0,1,10,11
1,9,2,0.46,0.4545,0.1343,0,8,8
1,8,7,0.64,0.5909,0.19399999999999998,14,88,102
1,7,12,0.78,0.6970000000000001,0.0,69,223,292
1,9,11,0.62,0.6212,0.0,37,206,243
0,1,8,0.22,0.2121,0.2836,0,18,18
1,7,11,0.84,0.8029999999999999,0.3284,45,156,201
1,6,18,0.86,0.7273,0.2239,100,597,697
1,8,20,0.74,0.6970000000000001,0.2985,55,315,370
0,12,9,0.26,0.2879,0.0896,8,256,264
1,12,0,0.22,0.2121,0.2836,3,24,27
1,2,1,0.32,0.3333,0.1343,3,4,7
0,7,21,0.78,0.7424,0.2537,77,168,245
1,4,18,0.52,0.5,0.3582,94,560,654
1,9,18,0.62,0.5909,0.1642,66,708,774
0,11,19,0.5,0.4848,0.1045,17,140,157
0,4,0,0.3,0.3333,0.0,3,29,32
0,6,4,0.6,0.6061,0.0896,3,8,11
0,9,13,0.72,0.6667,0.0896,50,169,219
0,4,3,0.36,0.3333,0.2985,0,2,2
0,1,7,0.12,0.1212,0.2239,2,75,77
0,12,23,0.26,0.2879,0.0896,3,70,73
0,4,3,0.4,0.4091,0.3284,0,2,2
1,10,20,0.4,0.4091,0.1343,19,97,116
1,6,17,0.7,0.6364,0.2537,192,386,578
1,8,17,0.82,0.7273,0.2239,93,751,844
0,9,6,0.66,0.6212,0.1343,6,5,11
1,2,3,0.44,0.4394,0.19399999999999998,0,3,3
0,3,18,0.46,0.4545,0.4925,8,193,201
1,5,18,0.64,0.6061,0.1045,31,296,327
0,4,22,0.42,0.4242,0.1642,36,110,146
1,8,15,0.82,0.7273,0.2239,80,194,274
1,4,20,0.74,0.6515,0.2985,48,327,375
0,8,1,0.68,0.6364,0.3881,4,11,15
1,11,7,0.26,0.2576,0.19399999999999998,6,403,409
1,8,14,0.64,0.6061,0.0,41,108,149
0,1,19,0.32,0.303,0.2537,14,60,74
0,9,21,0.6,0.5455,0.2537,7,67,74
1,3,23,0.36,0.3788,0.0,16,107,123
1,3,12,0.48,0.4697,0.0,263,358,621
1,2,16,0.54,0.5152,0.4478,20,266,286
1,4,19,0.66,0.6212,0.2239,75,419,494
0,8,14,0.74,0.6970000000000001,0.19399999999999998,126,244,370
0,4,7,0.5,0.4848,0.0,16,11,27
1,3,22,0.36,0.3788,0.0,6,69,75
1,1,1,0.34,0.3333,0.19399999999999998,10,62,72
0,7,4,0.68,0.6364,0.0896,0,6,6
1,5,14,0.62,0.6061,0.3284,8,63,71
1,10,13,0.56,0.5303,0.2239,37,109,146
1,5,4,0.54,0.5152,0.1343,1,3,4
0,3,15,0.34,0.3182,0.2537,21,64,85
1,10,3,0.56,0.5303,0.2537,2,2,4
0,2,22,0.34,0.3333,0.19399999999999998,12,61,73
1,6,20,0.68,0.6364,0.4179,86,362,448
0,8,3,0.66,0.5909,0.0896,0,3,3
1,6,23,0.66,0.5909,0.2239,11,78,89
0,12,9,0.26,0.2576,0.1642,10,223,233
0,3,22,0.3,0.2879,0.2239,0,40,40
0,4,2,0.32,0.303,0.2239,2,15,17
0,2,5,0.22,0.2424,0.1045,0,3,3
0,10,3,0.4,0.4091,0.0,1,9,10
0,10,3,0.56,0.5303,0.1343,1,6,7
0,3,12,0.4,0.4091,0.1045,23,65,88
0,10,21,0.44,0.4394,0.2985,16,149,165
0,11,7,0.26,0.2424,0.2836,3,31,34
1,7,20,0.76,0.7273,0.0896,79,206,285
1,11,9,0.3,0.3333,0.0,25,94,119
0,9,22,0.62,0.5606,0.0,50,143,193
0,2,19,0.3,0.3333,0.0,6,135,141
0,7,11,0.84,0.7424,0.19399999999999998,111,206,317
0,12,20,0.34,0.3485,0.1045,6,169,175
0,3,11,0.26,0.2121,0.4478,19,41,60
1,9,12,0.76,0.7121,0.2985,191,352,543
0,3,23,0.26,0.2424,0.2836,10,31,41
1,12,0,0.42,0.4242,0.1045,6,49,55
1,10,16,0.6,0.5909,0.1642,92,407,499
0,8,18,0.76,0.6970000000000001,0.2537,105,361,466
0,4,16,0.7,0.6515,0.3582,41,198,239
0,4,17,0.32,0.303,0.2537,10,138,148
0,4,23,0.46,0.4545,0.3582,5,27,32
0,3,9,0.3,0.2879,0.2836,13,143,156
1,8,5,0.6,0.5758,0.1642,7,30,37
0,1,8,0.16,0.1818,0.1343,5,233,238
0,12,2,0.28,0.303,0.0896,12,48,60
0,10,11,0.54,0.5152,0.0,29,115,144
0,6,4,0.64,0.6212,0.19399999999999998,7,4,11
0,12,6,0.32,0.303,0.2537,1,42,43
0,10,19,0.6,0.5455,0.1343,8,189,197
1,7,12,0.84,0.7273,0.19399999999999998,74,183,257
1,7,19,0.76,0.6667,0.1343,116,582,698
1,12,3,0.46,0.4545,0.3881,0,3,3
1,11,4,0.32,0.303,0.2985,8,8,16
0,1,23,0.24,0.2121,0.3284,3,28,31
1,3,5,0.4,0.4091,0.2239,2,30,32
0,2,1,0.44,0.4394,0.2239,1,7,8
1,5,21,0.58,0.5455,0.0896,7,145,152
0,2,11,0.36,0.3485,0.1343,33,92,125
0,11,9,0.32,0.2879,0.4478,15,186,201
0,9,13,0.54,0.5152,0.0,55,168,223
0,1,16,0.34,0.3333,0.19399999999999998,33,95,128
1,4,22,0.52,0.5,0.1642,11,123,134
1,9,11,0.64,0.6212,0.3881,228,399,627
0,6,12,0.74,0.6515,0.1642,175,268,443
1,4,0,0.4,0.4091,0.1343,1,32,33
1,5,11,0.7,0.6515,0.0896,221,354,575
0,1,9,0.32,0.3485,0.0,8,6,14
1,10,0,0.4,0.4091,0.0,3,28,31
1,2,17,0.34,0.3636,0.0,8,281,289
0,11,1,0.24,0.2424,0.1343,9,45,54
0,7,19,0.82,0.8485,0.1642,59,323,382
1,10,15,0.42,0.4242,0.1343,74,232,306
1,6,23,0.66,0.6212,0.0,29,145,174
0,8,15,0.9,0.7727,0.2836,48,120,168
0,3,2,0.22,0.2121,0.2239,4,21,25
0,3,21,0.3,0.2879,0.2537,9,49,58
0,5,18,0.56,0.5303,0.2239,88,216,304
1,7,23,0.68,0.6364,0.1642,33,90,123
1,11,3,0.36,0.3485,0.2239,0,2,2
1,9,3,0.7,0.6515,0.1045,6,29,35
1,8,0,0.72,0.6970000000000001,0.19399999999999998,16,51,67
0,11,10,0.4,0.4091,0.0896,25,108,133
0,2,23,0.18,0.2424,0.0,5,48,53
1,6,17,0.72,0.6515,0.2537,91,778,869
1,3,1,0.5,0.4848,0.1045,15,8,23
0,3,0,0.42,0.4242,0.3582,11,41,52
1,5,0,0.56,0.5303,0.1343,7,25,32
0,5,5,0.62,0.5455,0.1045,1,6,7
1,12,17,0.26,0.2424,0.2836,30,227,257
1,1,12,0.34,0.3485,0.1045,14,130,144
1,9,1,0.7,0.6667,0.0,2,16,18
1,1,11,0.18,0.1364,0.5224,12,63,75
0,8,2,0.78,0.7121,0.1642,2,9,11
1,12,11,0.48,0.4697,0.2239,58,211,269
0,8,6,0.64,0.5758,0.1045,5,22,27
0,1,20,0.18,0.2424,0.0,0,68,68
1,3,7,0.32,0.3182,0.1642,9,280,289
0,4,16,0.54,0.5152,0.3582,161,182,343
0,10,13,0.48,0.4697,0.3284,43,163,206
1,12,2,0.38,0.3939,0.0,1,4,5
1,9,12,0.68,0.6364,0.4478,16,72,88
0,10,10,0.46,0.4545,0.4478,25,105,130
0,8,0,0.64,0.6061,0.1045,8,23,31
1,2,4,0.24,0.2424,0.1343,0,9,9
1,10,4,0.44,0.4394,0.2239,0,5,5
0,12,10,0.32,0.3485,0.0,9,133,142
0,10,5,0.42,0.4242,0.2239,0,21,21
1,4,18,0.54,0.5152,0.2985,60,586,646
0,5,15,0.74,0.6970000000000001,0.2985,221,155,376
0,4,18,0.56,0.5303,0.3881,102,175,277
1,4,20,0.5,0.4848,0.1343,44,242,286
0,10,14,0.36,0.3485,0.19399999999999998,33,152,185
0,5,1,0.52,0.5,0.0,8,64,72
1,7,3,0.72,0.6818,0.1045,1,4,5
1,8,23,0.74,0.6818,0.1045,32,142,174
0,4,13,0.52,0.5,0.0896,36,99,135
0,8,10,0.74,0.6970000000000001,0.2836,91,199,290
0,8,12,0.82,0.7576,0.2537,48,134,182
1,10,8,0.6,0.5455,0.0,6,128,134
0,2,23,0.3,0.3333,0.0,6,19,25
1,8,3,0.72,0.6970000000000001,0.19399999999999998,3,6,9
0,8,14,0.74,0.6515,0.1642,58,151,209
0,4,1,0.44,0.4394,0.1642,15,59,74
1,3,7,0.46,0.4545,0.19399999999999998,25,329,354
0,2,23,0.4,0.4091,0.3582,3,27,30
0,5,10,0.72,0.6667,0.3881,42,111,153
1,12,6,0.24,0.2424,0.1343,1,15,16
0,10,10,0.34,0.3182,0.2239,28,102,130
1,6,3,0.64,0.5909,0.1045,2,4,6
0,9,2,0.4,0.4091,0.2836,3,7,10
0,8,4,0.64,0.6061,0.1343,5,5,10
1,2,23,0.36,0.3333,0.3881,12,62,74
0,12,13,0.28,0.2879,0.1045,36,95,131
0,8,12,0.76,0.7121,0.2239,53,152,205
0,7,14,0.86,0.8182,0.2836,79,204,283
0,7,10,0.8,0.7576,0.3582,44,73,117
1,5,18,0.8,0.7424,0.4925,78,632,710
1,7,6,0.72,0.6818,0.1343,8,144,152
0,9,11,0.58,0.5455,0.1642,41,98,139
1,1,16,0.52,0.5,0.2836,35,259,294
0,4,14,0.32,0.303,0.3284,97,93,190
1,12,11,0.3,0.3182,0.0896,43,43,86
1,6,10,0.74,0.6818,0.19399999999999998,177,317,494
1,10,19,0.48,0.4697,0.0,40,491,531
0,6,9,0.74,0.6818,0.1343,28,203,231
1,4,12,0.64,0.6212,0.2239,262,378,640
1,5,15,0.66,0.6212,0.19399999999999998,63,220,283
1,2,3,0.3,0.2727,0.2985,0,7,7
0,11,17,0.4,0.4091,0.2985,8,346,354
0,12,23,0.32,0.3333,0.1343,4,21,25
0,9,0,0.56,0.5303,0.1642,4,21,25
1,10,21,0.4,0.4091,0.19399999999999998,21,169,190
1,10,16,0.62,0.6212,0.1642,80,444,524
0,7,21,0.74,0.6818,0.1045,195,262,457
0,1,5,0.14,0.1818,0.0896,0,4,4
0,10,19,0.56,0.5303,0.0,51,243,294
0,5,22,0.56,0.5303,0.0,29,88,117
1,3,18,0.66,0.6212,0.1642,147,654,801
0,10,21,0.4,0.4091,0.5224,13,119,132
1,5,2,0.48,0.4697,0.1343,12,9,21
0,12,20,0.32,0.3333,0.0896,3,66,69
1,5,12,0.58,0.5455,0.2239,35,210,245
1,11,8,0.32,0.3485,0.0,16,130,146
1,6,6,0.62,0.5758,0.1045,8,136,144
1,11,19,0.4,0.4091,0.0,23,361,384
0,1,19,0.18,0.1515,0.4179,1,82,83
1,12,5,0.26,0.2727,0.1045,1,25,26
1,11,2,0.3,0.303,0.1642,0,9,9
0,8,3,0.62,0.5909,0.2239,1,5,6
1,5,0,0.5,0.4848,0.19399999999999998,7,28,35
1,5,12,0.62,0.5909,0.3582,46,125,171
0,10,6,0.26,0.2273,0.3582,4,1,5
1,8,22,0.62,0.5606,0.0896,20,94,114
1,12,13,0.58,0.5455,0.0896,81,240,321
1,7,18,0.9,0.8029999999999999,0.2537,106,454,560
1,1,23,0.16,0.19699999999999998,0.0896,3,26,29
0,6,3,0.62,0.5758,0.1642,0,2,2
0,3,12,0.26,0.2727,0.0,8,71,79
1,7,13,0.92,0.8333,0.2537,111,309,420
0,7,0,0.7,0.6667,0.1343,21,30,51
0,4,21,0.44,0.4394,0.2836,19,89,108
0,9,22,0.48,0.4697,0.0896,32,135,167
1,6,9,0.62,0.6212,0.2836,38,244,282
1,11,23,0.36,0.3636,0.1045,26,120,146
1,8,5,0.72,0.6970000000000001,0.2537,1,18,19
0,6,20,0.74,0.6970000000000001,0.2239,72,254,326
1,12,11,0.32,0.3182,0.1642,81,274,355
0,5,12,0.74,0.6818,0.1343,32,178,210
1,3,23,0.42,0.4242,0.2985,17,77,94
0,6,8,0.7,0.6515,0.2537,27,85,112
0,10,14,0.42,0.4242,0.3582,33,147,180
1,10,6,0.44,0.4394,0.2985,3,150,153
0,4,18,0.54,0.5152,0.1343,44,377,421
1,7,22,0.7,0.6667,0.2239,47,183,230
0,11,23,0.42,0.4242,0.1343,3,28,31
0,3,19,0.36,0.3333,0.3582,28,73,101
0,11,15,0.52,0.5,0.19399999999999998,165,145,310
0,8,13,0.8,0.7727,0.3284,176,265,441
0,3,5,0.3,0.303,0.1343,0,3,3
1,1,9,0.3,0.3333,0.0,18,256,274
1,8,10,0.82,0.7727,0.19399999999999998,108,288,396
0,9,10,0.64,0.5758,0.2239,19,101,120
1,4,16,0.64,0.6061,0.3284,232,244,476
0,5,22,0.58,0.5455,0.3881,14,99,113
1,11,17,0.34,0.303,0.3582,33,575,608
0,3,6,0.2,0.1818,0.3881,3,31,34
1,12,18,0.36,0.3485,0.1343,23,432,455
1,7,20,0.66,0.6061,0.2239,79,154,233
1,6,2,0.7,0.6515,0.2239,4,10,14
0,4,3,0.46,0.4545,0.4627,4,3,7
1,6,9,0.64,0.6061,0.0896,40,288,328
0,8,4,0.68,0.6364,0.19399999999999998,2,10,12
0,2,20,0.6,0.6212,0.19399999999999998,19,105,124
1,7,15,0.8,0.7273,0.1343,195,306,501
1,3,11,0.3,0.303,0.1642,34,141,175
0,6,6,0.66,0.6061,0.1343,4,87,91
0,12,1,0.26,0.2424,0.2836,1,9,10
1,11,0,0.32,0.3333,0.1045,7,58,65
1,5,4,0.62,0.5758,0.19399999999999998,4,7,11
1,3,21,0.62,0.6212,0.1045,64,220,284
1,10,10,0.54,0.5152,0.2836,165,314,479
1,8,15,0.82,0.7576,0.1642,89,206,295
1,12,11,0.32,0.3182,0.19399999999999998,20,183,203
0,11,17,0.44,0.4394,0.0896,4,161,165
1,5,17,0.78,0.7121,0.2537,235,227,462
1,3,17,0.72,0.6515,0.1642,264,693,957
0,3,6,0.42,0.4242,0.3582,1,1,2
0,11,3,0.3,0.3333,0.0,0,2,2
0,9,12,0.54,0.5152,0.3881,16,51,67
0,11,19,0.4,0.4091,0.3582,14,182,196
0,6,19,0.76,0.6667,0.3881,60,341,401
1,6,19,0.9,0.8788,0.19399999999999998,60,303,363
1,3,3,0.46,0.4545,0.0896,0,2,2
1,7,11,0.84,0.7273,0.2985,67,134,201
0,12,4,0.24,0.2576,0.0896,0,2,2
0,8,2,0.68,0.6364,0.0,16,58,74
0,6,5,0.58,0.5455,0.1642,2,30,32
0,2,14,0.38,0.3939,0.3881,2,61,63
1,3,22,0.42,0.4242,0.2836,17,135,152
1,8,20,0.74,0.6970000000000001,0.19399999999999998,76,424,500
0,12,8,0.36,0.3333,0.4179,10,449,459
0,3,15,0.32,0.303,0.2836,61,111,172
1,8,11,0.76,0.6818,0.1045,69,212,281
0,3,10,0.34,0.3182,0.2537,27,57,84
0,2,3,0.42,0.4242,0.2985,0,7,7
1,8,2,0.66,0.6212,0.0896,18,61,79
1,7,9,0.7,0.6667,0.1343,30,298,328
0,11,2,0.56,0.5303,0.2537,7,8,15
0,8,14,0.64,0.5758,0.5522,4,19,23
1,8,23,0.72,0.6818,0.1642,53,114,167
0,5,19,0.56,0.5303,0.1343,43,288,331
1,4,1,0.4,0.4091,0.2537,9,60,69
0,12,18,0.26,0.2576,0.2239,28,144,172
0,8,1,0.62,0.5758,0.0,10,13,23
1,4,16,0.64,0.6212,0.2836,86,304,390
0,1,13,0.2,0.19699999999999998,0.2239,0,22,22
0,4,5,0.42,0.4242,0.3881,3,4,7
0,8,14,0.74,0.6970000000000001,0.2537,113,146,259
1,6,18,0.7,0.6364,0.2537,153,343,496
0,9,6,0.62,0.5455,0.1642,1,55,56
1,3,16,0.62,0.6212,0.4478,77,255,332
0,7,17,0.84,0.7121,0.2239,81,491,572
0,5,15,0.72,0.6515,0.2537,232,274,506
1,2,22,0.14,0.1061,0.3881,0,46,46
1,3,10,0.24,0.2576,0.0,16,113,129
0,11,3,0.28,0.2879,0.1343,1,4,5
1,6,18,0.82,0.7273,0.2239,164,326,490
1,11,13,0.32,0.303,0.3284,64,161,225
0,5,19,0.52,0.5,0.19399999999999998,25,245,270
0,6,15,0.66,0.6212,0.1343,66,139,205
1,10,8,0.42,0.4242,0.19399999999999998,15,698,713
0,11,18,0.44,0.4394,0.0,0,148,148
1,4,15,0.48,0.4697,0.4179,132,192,324
0,7,0,0.7,0.6515,0.2239,47,97,144
1,8,23,0.66,0.6212,0.0,34,123,157
0,5,7,0.46,0.4545,0.3284,16,193,209
0,8,6,0.56,0.5303,0.1343,3,99,102
1,7,6,0.7,0.6515,0.1343,5,149,154
1,8,16,0.66,0.6212,0.2985,174,260,434
0,7,22,0.76,0.7273,0.2239,31,124,155
0,9,19,0.54,0.5152,0.4179,12,269,281
0,4,10,0.42,0.4242,0.3881,1,21,22
0,12,17,0.3,0.3182,0.1045,10,321,331
1,7,8,0.72,0.6970000000000001,0.1045,47,691,738
1,2,21,0.14,0.1212,0.2985,0,36,36
0,2,21,0.14,0.2121,0.0,2,70,72
0,9,13,0.68,0.6364,0.1343,72,207,279
1,6,5,0.52,0.5,0.0,2,33,35
1,8,17,0.8,0.6970000000000001,0.0,186,319,505
0,3,15,0.44,0.4394,0.2239,3,4,7
1,12,1,0.26,0.2273,0.2985,0,7,7
1,7,10,0.82,0.7727,0.2239,129,266,395
0,4,8,0.32,0.303,0.1642,7,47,54
1,8,22,0.76,0.7121,0.19399999999999998,65,212,277
1,8,22,0.72,0.6818,0.0896,28,161,189
1,4,0,0.54,0.5152,0.19399999999999998,30,94,124
0,1,10,0.18,0.2121,0.1045,0,49,49
0,10,16,0.52,0.5,0.0896,17,196,213
0,8,1,0.72,0.6818,0.0,5,9,14
1,11,17,0.4,0.4091,0.2239,37,652,689
1,4,21,0.46,0.4545,0.1642,13,213,226
0,11,17,0.32,0.3333,0.1343,17,361,378
0,1,17,0.12,0.19699999999999998,0.0,8,59,67
1,7,23,0.68,0.6364,0.2985,52,187,239
0,4,21,0.42,0.4242,0.19399999999999998,10,74,84
1,5,23,0.66,0.6061,0.2239,34,132,166
1,2,21,0.44,0.4394,0.2239,17,205,222
0,12,15,0.3,0.3182,0.0896,27,150,177
0,6,4,0.62,0.5606,0.1642,1,2,3
0,8,10,0.72,0.6818,0.1045,114,192,306
0,11,13,0.6,0.6212,0.3881,50,153,203
0,3,17,0.36,0.3485,0.2239,39,209,248
0,11,20,0.42,0.4242,0.0,55,86,141
1,1,9,0.24,0.2273,0.2537,18,218,236
0,3,6,0.4,0.4091,0.2537,2,58,60
1,8,16,0.8,0.7121,0.0896,116,348,464
1,10,7,0.38,0.3939,0.0896,15,437,452
0,6,18,0.88,0.8029999999999999,0.2836,52,414,466
0,5,21,0.54,0.5152,0.0,32,202,234
1,5,18,0.56,0.5303,0.5224,109,661,770
0,4,16,0.58,0.5455,0.19399999999999998,191,273,464
0,2,7,0.18,0.2424,0.0,6,89,95
0,6,21,0.66,0.6212,0.0896,29,160,189
1,4,9,0.42,0.4242,0.4925,42,292,334
1,7,4,0.66,0.5909,0.1343,0,8,8
1,1,10,0.32,0.3333,0.0896,23,93,116
0,11,13,0.48,0.4697,0.2239,84,91,175
1,1,1,0.14,0.1667,0.1045,2,18,20
1,5,14,0.66,0.6212,0.1343,108,242,350
1,3,4,0.5,0.4848,0.1045,0,3,3
1,2,14,0.32,0.2727,0.5522,35,181,216
0,2,8,0.22,0.2121,0.2239,1,154,155
0,6,2,0.64,0.6212,0.1642,16,48,64
0,3,22,0.34,0.303,0.3284,8,30,38
0,1,1,0.16,0.19699999999999998,0.0896,2,18,20
1,10,5,0.46,0.4545,0.0896,2,38,40
1,3,0,0.28,0.2576,0.2836,3,12,15
0,2,11,0.44,0.4394,0.5821,47,76,123
0,9,16,0.62,0.6212,0.2239,62,298,360
1,9,9,0.6,0.6061,0.0896,46,292,338
0,11,5,0.3,0.3333,0.0,0,27,27
0,10,11,0.62,0.6212,0.0896,189,234,423
0,6,12,0.74,0.6818,0.0896,141,255,396
0,4,15,0.54,0.5152,0.5224,179,209,388
1,3,3,0.58,0.5455,0.2537,1,4,5
0,8,13,0.76,0.6970000000000001,0.1343,158,220,378
0,12,2,0.26,0.2273,0.2985,1,8,9
1,6,3,0.74,0.7121,0.0,1,6,7
0,11,20,0.36,0.3333,0.2836,15,171,186
1,3,12,0.66,0.6212,0.2239,199,272,471
0,2,20,0.48,0.4697,0.3284,8,131,139
1,2,17,0.42,0.4242,0.0896,33,497,530
1,4,17,0.74,0.6515,0.3881,259,309,568
0,9,1,0.62,0.5152,0.1642,0,8,8
1,8,19,0.82,0.7727,0.3582,133,264,397
0,6,10,0.62,0.6212,0.2239,33,97,130
0,10,21,0.36,0.3485,0.19399999999999998,7,109,116
1,6,2,0.56,0.5303,0.1343,2,12,14
1,11,19,0.32,0.3485,0.0,18,359,377
1,2,12,0.32,0.303,0.3284,1,69,70
0,7,4,0.72,0.6818,0.0,6,7,13
0,12,15,0.32,0.3333,0.1343,19,98,117
1,2,5,0.1,0.1212,0.1343,0,17,17
0,4,4,0.28,0.303,0.0896,3,0,3
1,10,21,0.62,0.5455,0.1045,24,265,289
1,8,15,0.78,0.6970000000000001,0.1343,104,201,305
0,9,20,0.54,0.5152,0.0896,44,136,180
0,9,9,0.66,0.6061,0.1642,87,102,189
1,9,21,0.62,0.6061,0.1045,26,291,317
1,7,17,0.76,0.6970000000000001,0.3284,62,765,827
0,12,15,0.5,0.4848,0.19399999999999998,2,43,45
1,7,12,0.8,0.7273,0.0,50,198,248
0,3,9,0.24,0.2121,0.2985,16,150,166
1,7,14,0.86,0.7727,0.2537,186,308,494
1,5,16,0.72,0.6515,0.3582,238,339,577
0,1,18,0.3,0.3182,0.0896,7,218,225
0,11,9,0.48,0.4697,0.1045,15,222,237
1,2,22,0.34,0.3485,0.1045,6,95,101
1,11,1,0.34,0.3485,0.0896,26,82,108
1,12,21,0.32,0.3182,0.19399999999999998,14,193,207
0,8,15,0.8,0.6970000000000001,0.2985,52,126,178
1,5,7,0.52,0.5,0.2836,21,442,463
1,3,12,0.6,0.5758,0.2537,56,205,261
0,12,10,0.4,0.4091,0.1642,20,108,128
0,6,13,0.84,0.7576,0.1045,40,149,189
1,8,17,0.78,0.7424,0.1343,125,743,868
1,6,17,0.64,0.6212,0.2239,232,361,593
0,9,4,0.56,0.5303,0.1045,1,7,8
0,1,2,0.14,0.1515,0.1343,0,1,1
0,5,11,0.58,0.5455,0.2239,43,136,179
1,9,1,0.6,0.5909,0.0,8,101,109
1,8,13,0.74,0.6515,0.19399999999999998,289,355,644
1,12,19,0.3,0.2424,0.2537,7,90,97
0,1,2,0.16,0.19699999999999998,0.0896,0,2,2
1,6,8,0.58,0.5455,0.0896,37,663,700
0,3,11,0.34,0.3182,0.2537,26,64,90
1,6,1,0.68,0.6364,0.19399999999999998,7,20,27
1,2,19,0.32,0.3333,0.1045,8,287,295
0,4,11,0.6,0.6212,0.2239,49,108,157
1,12,0,0.24,0.2576,0.0896,3,10,13
0,4,22,0.42,0.4242,0.0,2,22,24
1,1,19,0.32,0.303,0.2239,1,92,93
1,2,15,0.4,0.4091,0.2836,3,87,90
1,4,7,0.36,0.3636,0.1045,8,56,64
1,8,16,0.72,0.6667,0.2537,103,357,460
1,8,3,0.62,0.5606,0.19399999999999998,7,23,30
1,10,15,0.52,0.5,0.1642,102,358,460
1,8,1,0.62,0.5455,0.1642,14,78,92
1,6,13,0.84,0.7273,0.1343,204,288,492
1,12,3,0.36,0.3636,0.1045,6,23,29
0,3,6,0.4,0.4091,0.19399999999999998,1,35,36
1,8,8,0.7,0.6515,0.1642,41,664,705
0,1,21,0.08,0.0758,0.2836,0,41,41
0,9,4,0.4,0.4091,0.2836,1,3,4
0,8,6,0.7,0.6515,0.2836,8,87,95
1,10,0,0.46,0.4545,0.0896,0,33,33
1,4,4,0.42,0.4242,0.0,0,4,4
1,10,9,0.62,0.5758,0.19399999999999998,30,332,362
0,12,15,0.38,0.3939,0.1045,24,143,167
0,6,8,0.62,0.5606,0.1045,33,368,401
0,6,16,0.86,0.8029999999999999,0.2836,41,220,261
1,6,12,0.84,0.7121,0.2836,49,227,276
1,3,13,0.7,0.6515,0.0,172,256,428
1,11,22,0.3,0.3333,0.0,18,145,163
1,1,17,0.34,0.3182,0.2239,6,128,134
1,6,5,0.5,0.4848,0.19399999999999998,1,11,12
0,6,8,0.74,0.6970000000000001,0.19399999999999998,20,412,432
0,4,6,0.56,0.5303,0.2537,5,79,84
1,10,4,0.36,0.3485,0.1642,1,6,7
1,5,20,0.66,0.6212,0.2836,67,163,230
0,4,4,0.46,0.4545,0.0896,1,4,5
0,10,3,0.4,0.4091,0.1045,3,3,6
0,12,4,0.26,0.2424,0.2836,0,1,1
0,4,11,0.4,0.4091,0.1343,93,109,202
1,8,5,0.64,0.5909,0.0,1,37,38
1,6,9,0.64,0.5758,0.2239,24,274,298
1,1,3,0.12,0.19699999999999998,0.0,0,3,3
0,10,3,0.54,0.5152,0.19399999999999998,2,4,6
1,5,23,0.52,0.5,0.19399999999999998,22,80,102
1,9,5,0.44,0.4394,0.1045,4,52,56
0,11,6,0.38,0.3939,0.1642,0,9,9
0,5,0,0.56,0.5303,0.1343,23,18,41
1,8,16,0.86,0.7727,0.2537,97,320,417
0,8,2,0.6,0.5909,0.19399999999999998,8,5,13
0,6,17,0.74,0.6818,0.1343,90,514,604
0,8,1,0.72,0.6667,0.19399999999999998,7,10,17
0,4,8,0.34,0.3182,0.2537,15,331,346
1,12,23,0.26,0.2727,0.1343,12,37,49
1,11,23,0.22,0.2576,0.0896,1,40,41
0,12,17,0.34,0.3485,0.1045,10,352,362
0,2,6,0.34,0.3485,0.0896,0,11,11
0,7,5,0.58,0.5455,0.0896,4,6,10
0,4,5,0.42,0.4242,0.5522,0,14,14
1,1,4,0.32,0.303,0.3284,0,2,2
1,10,13,0.44,0.4394,0.0896,80,240,320
0,9,1,0.52,0.5,0.1045,3,7,10
1,11,12,0.38,0.3939,0.2239,150,354,504
1,11,2,0.4,0.4091,0.1343,6,14,20
1,3,4,0.34,0.3485,0.0896,1,1,2
0,12,17,0.36,0.3788,0.0,46,186,232
0,7,14,0.82,0.7879,0.3284,32,106,138
1,4,22,0.5,0.4848,0.1045,7,61,68
0,8,13,0.76,0.6818,0.3582,129,302,431
0,8,10,0.74,0.6515,0.2537,36,96,132
0,12,10,0.32,0.3333,0.1343,36,180,216
0,7,4,0.74,0.6818,0.2537,0,5,5
0,7,21,0.66,0.6212,0.1343,58,203,261
0,3,6,0.14,0.1212,0.2985,1,34,35
1,2,2,0.26,0.303,0.0,0,1,1
0,6,12,0.88,0.8182,0.1343,15,134,149
1,7,1,0.66,0.6212,0.0,0,21,21
0,12,16,0.44,0.4394,0.3284,6,95,101
1,7,3,0.66,0.6061,0.1642,1,5,6
0,9,16,0.7,0.6515,0.1642,74,239,313
1,2,19,0.2,0.1515,0.5522,2,85,87
0,9,9,0.64,0.5758,0.0,55,100,155
0,11,11,0.34,0.2879,0.4925,20,150,170
1,3,12,0.44,0.4394,0.1343,72,222,294
0,7,5,0.64,0.5909,0.1045,2,15,17
1,1,7,0.16,0.1667,0.1642,3,10,13
1,9,16,0.84,0.7879,0.1642,209,253,462
1,4,14,0.76,0.6818,0.3284,105,183,288
0,9,12,0.72,0.6818,0.2239,144,260,404
1,7,1,0.68,0.6364,0.1045,17,42,59
1,7,15,0.8,0.7576,0.1642,243,317,560
1,8,3,0.66,0.6212,0.1045,1,10,11
1,6,17,0.82,0.7121,0.2537,214,316,530
1,9,10,0.62,0.6212,0.1045,160,330,490
1,8,18,0.86,0.7576,0.2537,87,459,546
0,12,17,0.26,0.2576,0.2239,12,153,165
0,9,0,0.62,0.5606,0.0,29,79,108
1,11,17,0.36,0.3485,0.2239,22,541,563
0,4,4,0.56,0.5303,0.2537,2,4,6
0,3,10,0.24,0.2121,0.2836,13,55,68
0,8,15,0.86,0.7424,0.3284,53,141,194
1,12,18,0.46,0.4545,0.2836,20,544,564
1,5,3,0.5,0.4848,0.19399999999999998,2,3,5
1,11,8,0.34,0.303,0.2985,10,132,142
0,3,20,0.32,0.3182,0.19399999999999998,4,87,91
0,7,23,0.8,0.7879,0.19399999999999998,19,84,103
1,5,2,0.6,0.5606,0.2239,20,28,48
0,12,4,0.16,0.1667,0.1642,0,5,5
1,10,3,0.6,0.5152,0.0,0,7,7
0,8,20,0.64,0.5909,0.3582,33,192,225
0,7,14,0.86,0.7879,0.2537,39,121,160
0,1,8,0.24,0.2576,0.1045,1,196,197
0,1,15,0.22,0.2273,0.1642,3,32,35
0,2,10,0.2,0.2121,0.1343,5,46,51
0,7,22,0.8,0.7424,0.2239,47,127,174
1,12,11,0.36,0.3485,0.1343,47,248,295
0,11,0,0.24,0.2424,0.1343,12,52,64
1,2,10,0.26,0.2576,0.2239,1,107,108
1,8,22,0.7,0.6515,0.0,42,209,251
1,11,2,0.3,0.303,0.1642,2,4,6
0,1,9,0.14,0.1212,0.3284,2,137,139
0,6,5,0.58,0.5455,0.2537,1,24,25
1,4,12,0.68,0.6364,0.2537,75,196,271
1,12,21,0.46,0.4545,0.19399999999999998,21,224,245
1,12,19,0.38,0.3939,0.0,15,337,352
1,1,12,0.5,0.4848,0.1642,25,155,180
0,7,11,0.84,0.8333,0.19399999999999998,24,83,107
1,9,12,0.76,0.7273,0.2836,54,233,287
1,12,16,0.38,0.3939,0.2239,24,334,358
0,7,2,0.72,0.6667,0.1045,2,5,7
1,9,8,0.6,0.5758,0.1642,51,715,766
1,1,8,0.24,0.2121,0.3582,11,408,419
1,2,4,0.24,0.2576,0.0896,1,5,6
1,1,11,0.26,0.2879,0.0896,6,82,88
1,3,12,0.56,0.5303,0.2239,16,204,220
1,2,16,0.34,0.3182,0.2537,28,240,268
1,10,18,0.56,0.5303,0.1045,77,732,809
1,5,0,0.62,0.5758,0.2239,21,44,65
1,12,19,0.34,0.3636,0.0,16,86,102
1,6,19,0.7,0.6364,0.19399999999999998,184,277,461
1,9,14,0.76,0.6818,0.2836,250,404,654
1,4,10,0.6,0.6212,0.4179,52,165,217
1,2,1,0.08,0.0455,0.4627,0,24,24
1,4,1,0.34,0.3182,0.2836,3,9,12
1,11,21,0.54,0.5152,0.2239,10,145,155
0,4,18,0.5,0.4848,0.3881,6,32,38
0,5,18,0.7,0.6364,0.1642,191,253,444
0,11,14,0.56,0.5303,0.1642,30,115,145
1,4,20,0.58,0.5455,0.1642,52,289,341
1,3,16,0.64,0.6212,0.0,367,318,685
0,10,6,0.5,0.4848,0.0,4,42,46
0,4,22,0.3,0.303,0.1642,10,64,74
1,12,12,0.28,0.3182,0.0,29,206,235
0,6,5,0.6,0.6061,0.0,3,9,12
1,3,6,0.28,0.2576,0.3881,4,104,108
0,9,23,0.52,0.5,0.3284,23,109,132
0,9,6,0.6,0.5455,0.1045,4,13,17
1,1,13,0.5,0.4848,0.4627,26,175,201
0,5,12,0.56,0.5303,0.4179,38,115,153
1,6,19,0.68,0.6364,0.19399999999999998,47,444,491
1,6,17,0.66,0.5909,0.2836,56,625,681
1,5,10,0.6,0.6061,0.2537,128,222,350
0,5,9,0.8,0.7576,0.1343,22,153,175
1,10,2,0.54,0.5152,0.1045,0,2,2
0,11,15,0.58,0.5455,0.1642,18,132,150
1,5,13,0.74,0.6818,0.1343,86,247,333
1,4,23,0.32,0.3182,0.1642,10,49,59
0,7,8,0.68,0.6364,0.2239,39,53,92
1,2,16,0.34,0.3333,0.1642,20,123,143
1,11,19,0.32,0.3182,0.1642,11,361,372
0,2,1,0.22,0.2273,0.19399999999999998,0,3,3
0,7,14,0.8,0.7273,0.0,235,173,408
1,1,1,0.24,0.2576,0.0896,1,6,7
0,3,9,0.32,0.303,0.3284,13,127,140
1,8,16,0.9,0.8182,0.2985,197,253,450
1,12,22,0.36,0.3636,0.0896,15,150,165
1,3,14,0.62,0.6212,0.3582,52,169,221
0,9,15,0.72,0.6667,0.1343,39,135,174
0,4,20,0.54,0.5152,0.2537,45,138,183
1,1,11,0.3,0.2727,0.3881,4,110,114
0,7,2,0.7,0.6515,0.2239,8,4,12
1,3,6,0.42,0.4242,0.19399999999999998,7,110,117
1,10,19,0.66,0.6212,0.1045,67,467,534
0,10,21,0.54,0.5152,0.1045,53,120,173
1,2,14,0.32,0.3182,0.19399999999999998,57,206,263
1,4,3,0.44,0.4394,0.1045,1,9,10
0,6,19,0.68,0.6364,0.1642,108,249,357
0,12,22,0.3,0.303,0.1642,5,102,107
1,8,14,0.76,0.6818,0.1343,74,199,273
0,3,17,0.54,0.5152,0.2537,41,231,272
0,12,10,0.34,0.2879,0.5224,31,39,70
0,7,19,0.76,0.6970000000000001,0.2836,145,234,379
1,7,0,0.72,0.6667,0.2985,9,57,66
1,2,8,0.24,0.2424,0.0,14,514,528
0,1,21,0.2,0.19699999999999998,0.19399999999999998,3,40,43
0,1,12,0.2,0.19699999999999998,0.2537,2,59,61
0,10,14,0.62,0.6212,0.3582,37,119,156
0,7,14,0.9,0.7727,0.1642,130,196,326
1,5,15,0.64,0.6061,0.19399999999999998,67,158,225
0,11,22,0.26,0.2424,0.2537,1,83,84
1,7,4,0.72,0.6818,0.1343,0,6,6
0,2,20,0.26,0.2727,0.1045,3,98,101
1,4,15,0.48,0.4697,0.2537,42,169,211
1,2,2,0.3,0.3182,0.0896,1,6,7
1,7,4,0.72,0.6667,0.0,0,7,7
1,1,18,0.44,0.4394,0.19399999999999998,22,399,421
0,11,0,0.36,0.3788,0.0,7,39,46
0,8,5,0.64,0.5758,0.0,1,16,17
1,5,1,0.6,0.5758,0.1045,15,33,48
0,7,6,0.6,0.5909,0.1045,12,108,120
1,1,16,0.26,0.2273,0.3284,8,185,193
0,7,11,0.7,0.6515,0.1343,73,137,210
1,5,4,0.48,0.4697,0.0896,6,8,14
0,11,14,0.52,0.5,0.1642,32,120,152
0,1,7,0.16,0.2273,0.0,0,95,95
1,1,1,0.38,0.3939,0.1642,6,56,62
0,11,23,0.32,0.303,0.3284,17,72,89
0,12,16,0.38,0.3939,0.0,75,230,305
1,8,13,0.86,0.7879,0.2239,98,212,310
0,11,6,0.36,0.3485,0.2239,3,72,75
0,7,16,0.94,0.8788,0.1343,70,151,221
0,11,9,0.36,0.3788,0.0,14,177,191
0,9,14,0.54,0.5152,0.2836,3,21,24
1,2,14,0.44,0.4394,0.3582,183,244,427
1,2,19,0.26,0.2727,0.1343,5,75,80
0,8,17,0.74,0.7121,0.6418,63,131,194
1,5,4,0.52,0.5,0.1642,9,7,16
0,4,7,0.54,0.5152,0.2239,12,177,189
1,8,4,0.64,0.5758,0.19399999999999998,5,11,16
1,10,18,0.56,0.5303,0.1045,21,212,233
1,9,15,0.6,0.6212,0.0,84,216,300
1,3,20,0.58,0.5455,0.3582,60,270,330
1,3,17,0.6,0.5909,0.19399999999999998,108,642,750
1,1,8,0.32,0.3333,0.1343,11,479,490
0,10,3,0.44,0.4394,0.0896,0,1,1
0,5,3,0.42,0.4242,0.5224,0,1,1
1,5,6,0.56,0.5303,0.2239,2,22,24
1,1,17,0.42,0.4242,0.5821,16,406,422
1,2,5,0.26,0.2879,0.0896,0,29,29
1,7,7,0.74,0.6970000000000001,0.1642,23,472,495
1,5,11,0.56,0.5303,0.1045,144,270,414
1,11,23,0.32,0.3333,0.1045,1,82,83
0,9,21,0.62,0.5758,0.0896,66,156,222
1,1,19,0.26,0.2576,0.1642,9,211,220
0,5,3,0.48,0.4697,0.1045,7,12,19
1,7,21,0.72,0.6667,0.2239,69,322,391
1,1,21,0.3,0.2879,0.2836,0,69,69
1,12,14,0.36,0.3485,0.19399999999999998,43,171,214
0,10,12,0.54,0.5152,0.3582,35,165,200
0,4,14,0.74,0.6515,0.4627,33,115,148
0,3,18,0.32,0.3182,0.1642,64,89,153
1,6,22,0.68,0.6364,0.1343,42,155,197
0,7,14,0.72,0.6970000000000001,0.19399999999999998,28,62,90
1,1,12,0.16,0.1515,0.2239,24,161,185
0,6,18,0.76,0.6818,0.19399999999999998,62,388,450
0,10,15,0.58,0.5455,0.1343,62,157,219
1,11,7,0.36,0.3485,0.1642,6,414,420
1,12,1,0.26,0.303,0.0,5,64,69
0,6,17,0.74,0.6515,0.1045,83,555,638
0,12,8,0.32,0.3333,0.1343,5,13,18
0,12,5,0.36,0.3485,0.2239,1,0,1
0,1,23,0.16,0.19699999999999998,0.0896,3,30,33
1,4,16,0.5,0.4848,0.4179,184,352,536
0,10,16,0.22,0.19699999999999998,0.3284,3,19,22
1,2,12,0.4,0.4091,0.3284,9,163,172
1,5,1,0.56,0.5303,0.1343,5,14,19
1,8,22,0.64,0.5909,0.0,24,208,232
1,1,7,0.34,0.3182,0.2836,2,218,220
0,2,19,0.24,0.2424,0.1343,1,102,103
1,8,15,0.76,0.6667,0.2239,250,346,596
0,4,13,0.36,0.3333,0.4179,5,51,56
1,9,19,0.62,0.6212,0.1343,91,312,403
1,12,14,0.58,0.5455,0.2239,39,231,270
1,3,16,0.54,0.5152,0.0896,229,312,541
1,12,6,0.16,0.19699999999999998,0.0896,4,5,9
1,4,23,0.5,0.4848,0.0,13,66,79
1,10,0,0.56,0.5303,0.1045,5,51,56
1,12,22,0.5,0.4848,0.2239,11,115,126
1,4,18,0.62,0.6212,0.2836,110,558,668
1,5,0,0.52,0.5,0.1642,25,111,136
1,10,13,0.54,0.5152,0.1343,73,237,310
1,12,20,0.36,0.3636,0.0896,6,102,108
0,7,22,0.66,0.6212,0.2239,71,152,223
1,12,15,0.4,0.4091,0.1642,57,252,309
0,1,3,0.1,0.0758,0.4179,0,4,4
0,6,16,0.76,0.6667,0.1343,47,265,312
1,1,19,0.26,0.2424,0.2836,7,199,206
0,9,14,0.74,0.6818,0.2836,129,230,359
1,8,0,0.64,0.6061,0.0,14,51,65
1,5,1,0.6,0.5758,0.2537,3,11,14
0,9,4,0.58,0.5455,0.0896,3,4,7
1,5,17,0.68,0.6364,0.1045,75,603,678
0,4,12,0.34,0.303,0.3881,6,32,38
0,12,2,0.26,0.303,0.0,0,2,2
0,7,20,0.72,0.6667,0.2239,108,188,296
1,11,20,0.38,0.3939,0.0,11,224,235
1,10,23,0.36,0.3485,0.19399999999999998,11,89,100
1,6,16,0.88,0.7424,0.19399999999999998,56,331,387
0,2,1,0.24,0.2121,0.2985,2,25,27
0,5,18,0.6,0.6212,0.1642,79,394,473
0,12,23,0.2,0.2576,0.0,4,31,35
0,11,23,0.36,0.3788,0.0,3,45,48
1,11,0,0.3,0.2879,0.2836,49,234,283
1,5,14,0.64,0.6212,0.2537,68,175,243
1,3,15,0.5,0.4848,0.4179,118,172,290
1,8,14,0.86,0.2424,0.4179,128,200,328
1,4,17,0.62,0.6061,0.19399999999999998,123,634,757
0,1,2,0.22,0.2273,0.1642,0,15,15
0,2,5,0.12,0.1667,0.0896,0,1,1
1,8,11,0.74,0.6970000000000001,0.3582,150,332,482
1,6,1,0.58,0.5455,0.19399999999999998,9,42,51
1,1,17,0.26,0.2273,0.3284,19,174,193
1,8,1,0.6,0.5606,0.1642,0,10,10
1,6,5,0.52,0.5,0.1343,1,22,23
0,10,22,0.5,0.4848,0.0,16,88,104
1,1,4,0.2,0.2273,0.0896,0,5,5
1,10,6,0.3,0.2879,0.19399999999999998,5,23,28
1,6,5,0.54,0.5152,0.1045,2,31,33
1,7,1,0.7,0.6667,0.19399999999999998,1,10,11
1,12,9,0.24,0.2576,0.1045,17,68,85
0,8,18,0.72,0.6515,0.19399999999999998,98,421,519
0,4,23,0.44,0.4394,0.1642,19,37,56
1,7,11,0.72,0.6818,0.1045,143,296,439
0,4,11,0.52,0.5,0.1642,28,87,115
1,2,4,0.26,0.2576,0.2239,0,2,2
1,9,5,0.46,0.4545,0.0,2,35,37
0,3,12,0.56,0.5303,0.3582,72,123,195
1,2,18,0.48,0.4697,0.3284,42,483,525
1,3,17,0.62,0.6212,0.6567,52,545,597
0,4,4,0.38,0.3939,0.2985,1,1,2
1,8,8,0.7,0.6515,0.2836,40,642,682
0,9,23,0.62,0.5606,0.0,32,107,139
1,9,18,0.56,0.5303,0.19399999999999998,174,420,594
0,12,6,0.2,0.2576,0.0,0,92,92
0,11,1,0.34,0.303,0.3284,0,8,8
0,10,22,0.42,0.4242,0.1642,24,89,113
1,1,12,0.34,0.3333,0.1642,25,150,175
0,9,18,0.56,0.5303,0.1045,66,223,289
0,10,19,0.5,0.4848,0.0,25,306,331
1,8,11,0.76,0.7121,0.0896,54,180,234
1,9,20,0.66,0.6212,0.19399999999999998,45,389,434
0,6,21,0.64,0.6212,0.1045,51,196,247
0,5,16,0.66,0.6212,0.1045,56,271,327
1,2,11,0.32,0.303,0.2985,15,149,164
0,9,7,0.66,0.6212,0.1642,11,30,41
0,7,10,0.8,0.6970000000000001,0.2239,42,96,138
0,10,6,0.4,0.4091,0.1045,3,83,86
1,6,22,0.64,0.6061,0.2239,46,196,242
1,4,11,0.38,0.3939,0.1045,96,262,358
1,11,0,0.3,0.303,0.1642,11,118,129
1,4,19,0.34,0.3182,0.2239,11,287,298
0,3,1,0.24,0.2273,0.19399999999999998,1,4,5
0,2,16,0.28,0.2424,0.4179,8,48,56
1,12,17,0.38,0.3939,0.1045,29,214,243
0,11,9,0.56,0.5303,0.0896,26,174,200
1,10,11,0.66,0.6061,0.1642,52,178,230
0,8,2,0.66,0.5909,0.0896,2,5,7
1,8,21,0.7,0.6515,0.1343,53,276,329
0,8,9,0.7,0.6667,0.1642,70,138,208
0,1,11,0.22,0.1818,0.4627,6,53,59
0,5,15,0.48,0.4697,0.4179,22,107,129
0,9,1,0.58,0.5455,0.0896,18,61,79
0,12,14,0.42,0.4242,0.1343,77,246,323
0,10,7,0.46,0.4545,0.0896,9,128,137
1,11,6,0.28,0.303,0.0896,2,99,101
0,12,3,0.24,0.2576,0.1045,0,6,6
1,7,18,0.7,0.6667,0.2239,70,749,819
0,5,1,0.58,0.5455,0.19399999999999998,8,47,55
1,1,17,0.24,0.2576,0.1045,6,270,276
0,8,11,0.74,0.6818,0.1045,29,93,122
1,12,20,0.36,0.3333,0.2537,4,264,268
0,8,21,0.7,0.6667,0.2537,45,93,138
0,10,15,0.54,0.5152,0.2537,3,42,45
1,9,14,0.68,0.6212,0.0896,74,181,255
1,4,3,0.34,0.3333,0.1343,4,21,25
1,3,21,0.44,0.4394,0.19399999999999998,16,88,104
1,4,4,0.32,0.3182,0.1642,3,4,7
0,5,2,0.5,0.4848,0.0,3,12,15
1,11,19,0.36,0.3333,0.2537,24,203,227
0,3,1,0.42,0.4242,0.1343,6,13,19
0,11,5,0.24,0.2424,0.1343,0,5,5
1,7,10,0.7,0.6667,0.1642,51,182,233
1,4,13,0.58,0.5455,0.1642,229,254,483
1,1,16,0.46,0.4545,0.19399999999999998,33,248,281
0,6,14,0.76,0.7121,0.2239,44,108,152
1,10,20,0.42,0.4242,0.1642,27,388,415
1,6,8,0.58,0.5455,0.1642,47,157,204
1,12,22,0.3,0.3333,0.0,17,130,147
1,12,10,0.44,0.4394,0.2239,12,121,133
0,3,11,0.26,0.2424,0.2836,18,39,57
1,6,21,0.72,0.6667,0.19399999999999998,32,218,250
1,9,23,0.54,0.5152,0.0,47,182,229
0,6,11,0.9,0.8485,0.2239,36,82,118
1,4,1,0.36,0.3485,0.1642,13,49,62
1,10,1,0.5,0.4848,0.1343,23,123,146
0,12,13,0.4,0.4091,0.1343,19,188,207
0,2,1,0.14,0.1515,0.1343,0,7,7
0,12,17,0.28,0.2576,0.3284,34,151,185
1,10,16,0.56,0.5303,0.2836,257,355,612
1,7,8,0.74,0.6970000000000001,0.1642,36,127,163
1,1,18,0.2,0.2273,0.0896,5,296,301
1,1,23,0.22,0.2121,0.2537,2,32,34
0,10,4,0.24,0.2879,0.0,1,5,6
0,5,8,0.78,0.7424,0.1343,34,372,406
1,8,2,0.62,0.5606,0.1343,0,8,8
0,4,6,0.36,0.3182,0.4478,3,5,8
0,10,12,0.58,0.5455,0.2239,39,155,194
1,8,9,0.74,0.6970000000000001,0.0,61,337,398
1,5,9,0.62,0.6061,0.19399999999999998,23,282,305
0,9,0,0.58,0.5455,0.0896,7,86,93
0,3,20,0.3,0.303,0.1642,5,87,92
1,10,11,0.56,0.5303,0.1642,63,148,211
1,12,6,0.16,0.1667,0.1642,0,40,40
1,12,12,0.34,0.3636,0.0,14,218,232
1,1,10,0.14,0.1364,0.19399999999999998,19,107,126
0,3,22,0.32,0.3182,0.1642,1,20,21
0,8,2,0.66,0.5909,0.0,4,3,7
0,12,10,0.42,0.4242,0.19399999999999998,20,109,129
1,12,9,0.28,0.2727,0.1642,37,135,172
0,11,21,0.5,0.4848,0.0896,23,145,168
0,11,5,0.3,0.2879,0.2537,0,13,13
0,8,0,0.56,0.5303,0.1343,10,17,27
1,8,0,0.74,0.7121,0.1642,24,137,161
1,10,4,0.42,0.4242,0.1045,0,10,10
0,8,17,0.86,0.7727,0.1642,67,460,527
1,4,15,0.52,0.5,0.1045,55,176,231
1,3,9,0.24,0.2273,0.19399999999999998,8,259,267
0,7,19,0.86,0.7879,0.1045,40,210,250
0,3,4,0.3,0.303,0.1642,0,1,1
0,11,17,0.36,0.3485,0.2239,9,168,177
0,5,22,0.5,0.4848,0.2537,12,134,146
0,9,2,0.64,0.6061,0.2239,15,26,41
1,10,13,0.64,0.6212,0.0,59,244,303
1,9,9,0.64,0.6061,0.2537,88,289,377
0,7,1,0.7,0.6667,0.0,4,7,11
0,11,20,0.4,0.4091,0.1343,5,177,182
1,6,21,0.64,0.5909,0.2537,12,73,85
0,4,1,0.3,0.303,0.1343,3,17,20
1,8,3,0.72,0.6970000000000001,0.0896,0,5,5
0,6,14,0.74,0.6515,0.1343,197,246,443
0,4,13,0.52,0.5,0.3881,126,186,312
0,11,17,0.38,0.3939,0.3881,7,156,163
1,1,19,0.42,0.4242,0.5522,33,173,206
0,11,23,0.34,0.3485,0.1045,2,19,21
1,5,15,0.62,0.5909,0.1642,40,156,196
1,3,23,0.36,0.3485,0.2239,9,76,85
0,9,12,0.66,0.6212,0.2239,82,178,260
0,5,10,0.56,0.5303,0.19399999999999998,24,95,119
0,9,15,0.72,0.6818,0.1642,187,201,388
1,10,8,0.46,0.4545,0.0896,28,733,761
0,8,9,0.7,0.6667,0.0,39,191,230
1,8,3,0.62,0.6061,0.1642,21,34,55
0,1,15,0.2,0.1667,0.4478,5,69,74
1,8,6,0.64,0.5758,0.2985,3,41,44
0,3,21,0.44,0.4394,0.3284,12,60,72
1,8,22,0.72,0.6970000000000001,0.2836,50,168,218
0,5,6,0.52,0.5,0.1642,11,93,104
1,3,0,0.56,0.5303,0.0896,5,24,29
0,11,13,0.52,0.5,0.4179,105,234,339
0,6,17,0.76,0.6515,0.5224,88,484,572
0,11,11,0.36,0.3788,0.0,50,183,233
0,3,16,0.68,0.6364,0.2836,67,137,204
1,11,13,0.32,0.303,0.2537,23,158,181
0,12,1,0.2,0.2273,0.1045,3,43,46
0,1,20,0.18,0.2121,0.1045,1,50,51
1,10,9,0.36,0.3636,0.0896,46,220,266
1,7,20,0.64,0.5758,0.3881,35,216,251
1,2,11,0.26,0.2727,0.1343,12,104,116
1,8,15,0.8,0.7424,0.4478,100,224,324
0,8,16,0.72,0.6515,0.1343,133,311,444
1,11,3,0.32,0.3333,0.1343,1,3,4
1,2,13,0.38,0.3939,0.2239,17,124,141
0,9,5,0.54,0.5152,0.3582,1,20,21
0,2,14,0.36,0.3636,0.0896,8,52,60
1,7,17,0.8,0.6970000000000001,0.2239,90,740,830
0,5,6,0.42,0.4242,0.1343,9,103,112
1,4,6,0.34,0.3636,0.0,3,103,106
1,5,14,0.72,0.6515,0.3881,236,307,543
1,3,10,0.52,0.5,0.2239,28,115,143
1,5,23,0.6,0.6212,0.1642,71,168,239
1,6,13,0.88,0.7727,0.2537,105,323,428
0,9,2,0.52,0.5,0.1343,6,7,13
0,10,10,0.26,0.2273,0.3284,0,12,12
1,11,7,0.32,0.303,0.2537,1,58,59
1,1,0,0.14,0.1364,0.19399999999999998,0,16,16
1,3,6,0.42,0.4242,0.2537,4,105,109
1,2,9,0.2,0.19699999999999998,0.2239,9,229,238
0,5,6,0.52,0.5,0.2537,0,49,49
0,1,6,0.02,0.0758,0.0896,0,15,15
0,9,11,0.56,0.5303,0.1642,8,48,56
1,2,10,0.14,0.1515,0.1343,1,70,71
1,7,15,0.8,0.7121,0.1045,92,261,353
0,11,10,0.52,0.5,0.19399999999999998,6,70,76
1,11,15,0.36,0.3333,0.3284,7,172,179
0,3,1,0.26,0.2273,0.3582,0,3,3
0,8,4,0.64,0.6061,0.2239,0,9,9
0,2,4,0.22,0.2576,0.0896,1,1,2
1,2,1,0.38,0.3939,0.1642,0,6,6
0,8,22,0.7,0.6667,0.3284,24,96,120
0,8,10,0.72,0.6667,0.2985,24,89,113
1,5,19,0.62,0.6212,0.19399999999999998,91,392,483
0,10,9,0.52,0.5,0.4925,17,185,202
1,11,8,0.32,0.3182,0.1642,6,494,500
1,10,21,0.48,0.4697,0.0896,19,155,174
0,12,18,0.28,0.2727,0.2239,12,306,318
0,9,0,0.54,0.5152,0.3582,1,7,8
1,7,7,0.76,0.6970000000000001,0.0,27,316,343
1,11,8,0.36,0.3333,0.2985,13,650,663
0,1,1,0.22,0.2121,0.2537,2,5,7
1,8,21,0.74,0.6970000000000001,0.1045,70,311,381
0,6,2,0.66,0.6061,0.3284,4,10,14
1,10,22,0.5,0.4848,0.2836,8,118,126
0,7,23,0.72,0.6667,0.2836,66,88,154
1,5,9,0.6,0.5606,0.0,40,285,325
0,3,14,0.36,0.3333,0.2985,16,64,80
1,11,19,0.34,0.3636,0.0,16,355,371
1,11,5,0.34,0.3182,0.2836,0,18,18
0,6,19,0.62,0.5758,0.2836,58,269,327
0,2,2,0.32,0.3485,0.0,0,3,3
1,10,11,0.6,0.5606,0.19399999999999998,41,211,252
1,7,14,0.92,0.8333,0.2537,98,346,444
1,3,20,0.62,0.6212,0.1045,44,286,330
0,10,4,0.52,0.5,0.1343,0,5,5
0,9,10,0.7,0.6667,0.1343,150,147,297
1,7,9,0.74,0.7121,0.1343,57,288,345
0,6,10,0.72,0.6818,0.19399999999999998,68,176,244
1,4,20,0.36,0.3333,0.4179,1,34,35
1,10,14,0.6,0.5909,0.1343,71,214,285
0,12,19,0.32,0.303,0.2239,11,203,214
0,2,19,0.28,0.2879,0.1343,3,142,145
0,3,7,0.16,0.1667,0.1642,0,7,7
1,12,18,0.36,0.3636,0.0896,17,181,198
0,6,9,0.74,0.7121,0.2239,34,173,207
0,4,9,0.4,0.4091,0.2836,31,71,102
0,1,21,0.16,0.1515,0.19399999999999998,3,24,27
0,5,7,0.34,0.303,0.3582,6,46,52
0,11,7,0.42,0.4242,0.2239,4,19,23
1,6,8,0.64,0.5758,0.1642,26,168,194
1,3,12,0.26,0.303,0.0,15,122,137
0,5,19,0.56,0.5303,0.0,61,178,239
0,6,19,0.72,0.6667,0.1343,89,228,317
0,5,14,0.62,0.6212,0.2239,66,131,197
0,9,9,0.62,0.5152,0.1343,3,108,111
1,5,19,0.54,0.5152,0.3582,84,469,553
0,3,3,0.2,0.1667,0.4627,0,1,1
0,6,1,0.62,0.6061,0.1343,2,2,4
0,5,23,0.56,0.5303,0.0896,18,39,57
1,5,2,0.58,0.5455,0.0,24,51,75
0,12,23,0.24,0.2121,0.3881,0,16,16
1,8,16,0.8,0.7273,0.2985,227,304,531
0,9,9,0.48,0.4697,0.2537,46,94,140
0,4,8,0.38,0.3939,0.0896,17,38,55
1,1,20,0.42,0.4242,0.19399999999999998,11,229,240
0,2,23,0.26,0.2273,0.3284,2,37,39
1,8,14,0.82,0.7576,0.1642,88,175,263
1,2,22,0.24,0.2424,0.1343,3,95,98
0,4,14,0.34,0.3182,0.2239,2,13,15
0,10,20,0.24,0.2121,0.3582,7,40,47
1,4,15,0.5,0.4848,0.2537,295,278,573
1,7,9,0.74,0.6970000000000001,0.0,34,259,293
1,2,14,0.34,0.3485,0.0,68,263,331
0,9,11,0.62,0.5455,0.0,6,66,72
1,12,7,0.34,0.3485,0.0896,5,22,27
0,2,23,0.46,0.4545,0.2985,4,40,44
1,4,14,0.54,0.5152,0.19399999999999998,37,132,169
1,5,5,0.66,0.6061,0.2239,1,32,33
1,8,6,0.6,0.5606,0.2239,4,23,27
0,8,21,0.62,0.6212,0.0,38,173,211
1,10,18,0.52,0.5,0.4179,183,312,495
0,10,8,0.54,0.5152,0.0896,10,199,209
1,3,20,0.42,0.4242,0.0896,28,266,294
1,5,23,0.56,0.5303,0.1045,13,58,71
1,5,3,0.48,0.4697,0.0,14,20,34
0,8,20,0.72,0.6515,0.2239,77,210,287
1,5,11,0.76,0.7121,0.2985,50,147,197
1,2,9,0.24,0.2424,0.1343,16,141,157
1,3,2,0.46,0.4545,0.1642,1,7,8
1,12,20,0.38,0.3939,0.0,14,108,122
1,8,19,0.72,0.6667,0.1642,106,430,536
0,6,15,0.78,0.7424,0.2537,42,128,170
0,8,9,0.62,0.6212,0.2537,22,166,188
0,8,7,0.68,0.6364,0.2985,11,271,282
0,12,21,0.3,0.303,0.1343,4,15,19
0,11,6,0.34,0.3333,0.1343,5,18,23
0,11,9,0.3,0.2879,0.2836,7,186,193
1,4,3,0.4,0.4091,0.1642,0,4,4
1,7,13,0.8,0.6970000000000001,0.2239,52,225,277
1,11,2,0.28,0.2879,0.1045,8,65,73
1,12,20,0.28,0.2727,0.2537,8,104,112
1,3,12,0.4,0.4091,0.2985,146,264,410
0,8,7,0.68,0.6364,0.2985,12,19,31
1,6,17,0.8,0.7576,0.19399999999999998,86,725,811
1,5,19,0.66,0.6212,0.1642,57,455,512
1,8,23,0.64,0.2424,0.2239,21,100,121
0,1,4,0.22,0.2576,0.0896,0,1,1
0,8,12,0.9,0.8029999999999999,0.2537,53,115,168
1,6,18,0.82,0.7121,0.2985,194,287,481
0,6,17,0.82,0.7121,0.4179,78,492,570
1,10,11,0.56,0.5303,0.2239,79,189,268
0,12,7,0.26,0.2576,0.2239,0,20,20
1,3,9,0.26,0.2576,0.2239,20,70,90
0,1,12,0.26,0.2879,0.0,6,78,84
1,6,1,0.6,0.6212,0.2239,4,17,21
1,8,20,0.76,0.6818,0.0896,100,414,514
1,6,11,0.66,0.6212,0.1343,56,174,230
0,4,9,0.36,0.3485,0.19399999999999998,17,168,185
0,9,1,0.54,0.5152,0.0,0,17,17
0,10,0,0.56,0.5303,0.2985,4,22,26
0,7,5,0.72,0.6818,0.2836,4,9,13
0,3,9,0.26,0.2424,0.2537,5,136,141
1,8,11,0.74,0.6818,0.19399999999999998,80,155,235
0,5,18,0.64,0.6061,0.19399999999999998,68,450,518
1,3,14,0.62,0.6212,0.6418,48,155,203
0,4,4,0.36,0.3636,0.1045,2,5,7
1,10,11,0.54,0.5152,0.2239,204,408,612
1,11,4,0.34,0.3333,0.19399999999999998,0,6,6
1,5,0,0.52,0.5,0.1045,30,118,148
1,8,2,0.62,0.5758,0.0,9,11,20
1,6,23,0.8,0.7727,0.0896,12,134,146
0,11,19,0.38,0.3939,0.3881,6,116,122
0,6,7,0.54,0.5152,0.1343,22,348,370
1,5,19,0.76,0.7121,0.19399999999999998,230,212,442
0,9,17,0.56,0.5303,0.19399999999999998,95,230,325
1,12,0,0.26,0.2121,0.5821,1,30,31
1,1,18,0.34,0.303,0.3582,17,151,168
0,2,20,0.24,0.2424,0.1642,2,107,109
1,3,10,0.4,0.4091,0.1343,108,205,313
1,3,1,0.46,0.4545,0.1045,0,15,15
1,4,2,0.36,0.3485,0.1642,20,61,81
1,5,1,0.5,0.4848,0.1343,0,21,21
1,4,16,0.62,0.6061,0.1642,145,340,485
0,12,18,0.4,0.4091,0.0,10,362,372
0,2,12,0.32,0.3182,0.19399999999999998,26,67,93
1,9,2,0.48,0.4697,0.1642,1,5,6
0,11,10,0.44,0.4394,0.3284,63,178,241
0,8,9,0.66,0.5909,0.2836,27,76,103
1,2,3,0.24,0.2576,0.0896,4,13,17
0,8,12,0.74,0.6515,0.3881,54,153,207
1,11,19,0.32,0.3182,0.1642,9,378,387
0,6,19,0.74,0.7121,0.1642,16,248,264
1,2,0,0.32,0.303,0.2239,5,19,24
1,4,0,0.44,0.4394,0.2836,3,23,26
0,6,13,0.8,0.6818,0.3582,35,168,203
1,4,11,0.5,0.4848,0.2836,195,209,404
1,3,7,0.44,0.4394,0.19399999999999998,15,355,370
1,3,10,0.34,0.2879,0.4925,14,145,159
1,5,22,0.64,0.5909,0.1045,33,210,243
0,2,13,0.42,0.4242,0.0,90,169,259
1,9,19,0.58,0.5455,0.2239,69,534,603
0,11,14,0.34,0.3333,0.1343,31,123,154
0,7,21,0.7,0.6667,0.19399999999999998,66,175,241
1,6,17,0.84,0.7121,0.0,238,257,495
0,10,1,0.36,0.3636,0.0896,1,5,6
0,11,4,0.38,0.3939,0.1642,0,7,7
1,5,7,0.52,0.5,0.1642,5,31,36
0,1,19,0.08,0.1061,0.1343,6,53,59
1,4,8,0.3,0.2879,0.2239,14,581,595
0,1,9,0.06,0.1515,0.0,4,98,102
0,9,2,0.62,0.5909,0.19399999999999998,16,60,76
0,12,15,0.42,0.4242,0.3881,2,17,19
1,6,7,0.56,0.5303,0.2239,13,504,517
0,9,3,0.54,0.5152,0.2985,1,0,1
0,5,16,0.66,0.6212,0.2239,49,220,269
1,8,7,0.64,0.6061,0.2239,16,448,464
0,9,5,0.46,0.4545,0.1642,2,3,5
0,8,23,0.7,0.6667,0.1343,59,98,157
1,1,19,0.4,0.4091,0.1045,11,302,313
0,8,7,0.66,0.6061,0.0896,12,251,263
1,4,12,0.48,0.4697,0.1045,223,361,584
1,7,16,0.8,0.7273,0.1343,191,330,521
1,2,11,0.26,0.2424,0.2836,5,81,86
0,5,1,0.52,0.5,0.1343,17,81,98
1,11,1,0.24,0.2576,0.0896,2,17,19
0,1,13,0.22,0.19699999999999998,0.3881,4,73,77
1,11,1,0.32,0.3333,0.1045,1,13,14
1,9,18,0.66,0.6212,0.2537,91,886,977
1,7,14,0.8,0.7121,0.2239,66,175,241
0,7,16,0.92,0.7727,0.2836,98,208,306
1,4,19,0.5,0.4848,0.2537,66,428,494
1,3,5,0.22,0.2121,0.2836,3,7,10
1,6,10,0.9,0.8333,0.2985,32,139,171
1,6,1,0.66,0.6212,0.0,11,14,25
1,4,18,0.62,0.6212,0.2239,197,284,481
0,4,12,0.46,0.4545,0.5821,6,26,32
0,6,18,0.72,0.6515,0.2537,117,265,382
0,3,15,0.38,0.3939,0.2239,11,74,85
1,12,6,0.38,0.3939,0.1642,2,121,123
0,5,18,0.72,0.6667,0.2239,66,451,517
1,6,23,0.74,0.6818,0.1045,20,67,87
0,8,2,0.58,0.5455,0.1343,2,4,6
0,7,16,0.9,0.8485,0.2537,62,187,249
0,4,9,0.56,0.5303,0.2537,73,104,177
0,3,5,0.52,0.5,0.4179,0,2,2
1,12,10,0.44,0.4394,0.1343,31,105,136
1,9,7,0.44,0.4394,0.0,14,43,57
1,1,10,0.16,0.1364,0.2836,9,120,129
0,7,20,0.84,0.8939,0.2239,38,199,237
0,2,3,0.22,0.2273,0.1343,1,7,8
1,4,8,0.44,0.4394,0.0,32,668,700
0,4,20,0.64,0.6061,0.3582,35,199,234
1,12,16,0.3,0.2727,0.3284,28,253,281
1,6,22,0.52,0.5,0.0896,27,221,248
1,1,6,0.2,0.2121,0.1343,0,78,78
0,5,17,0.66,0.6212,0.19399999999999998,65,472,537
0,9,7,0.62,0.5455,0.1045,15,234,249
1,1,0,0.16,0.1364,0.3284,9,50,59
0,11,16,0.46,0.4545,0.1343,137,138,275
0,7,6,0.74,0.6818,0.2239,13,102,115
0,3,5,0.24,0.2273,0.2239,0,8,8
0,11,18,0.46,0.4545,0.3881,13,176,189
1,3,19,0.42,0.4242,0.6119,12,232,244
0,8,15,0.64,0.5758,0.5522,2,28,30
1,3,16,0.72,0.6515,0.3881,95,331,426
1,12,12,0.3,0.2879,0.19399999999999998,52,144,196
1,1,17,0.14,0.1061,0.4627,4,241,245
1,9,4,0.56,0.5303,0.2836,5,10,15
0,5,11,0.56,0.5303,0.0896,18,123,141
0,10,20,0.5,0.4848,0.1343,42,137,179
1,1,3,0.36,0.3485,0.2537,0,3,3
1,5,9,0.5,0.4848,0.4627,62,299,361
1,7,21,0.72,0.6970000000000001,0.0896,59,164,223
1,2,17,0.42,0.4242,0.4925,13,437,450
0,8,17,0.8,0.7424,0.19399999999999998,180,203,383
0,10,17,0.66,0.6212,0.1045,125,334,459
0,5,5,0.5,0.4848,0.19399999999999998,1,24,25
0,10,19,0.54,0.5152,0.1343,76,172,248
1,5,20,0.64,0.6061,0.2836,40,262,302
1,10,8,0.44,0.4394,0.0,32,696,728
1,2,9,0.36,0.3485,0.19399999999999998,9,267,276
0,7,22,0.7,0.6667,0.0,13,112,125
1,10,14,0.6,0.5455,0.1343,16,147,163
1,6,10,0.76,0.6970000000000001,0.1642,58,126,184
0,8,0,0.62,0.5909,0.1045,13,21,34
1,12,6,0.26,0.2424,0.1045,0,7,7
1,11,19,0.3,0.2879,0.2239,15,356,371
1,1,11,0.3,0.2727,0.2985,52,105,157
0,12,8,0.3,0.303,0.1642,9,155,164
0,3,12,0.46,0.4545,0.3284,10,69,79
1,8,17,0.8,0.7273,0.2239,101,744,845
0,3,20,0.56,0.5303,0.19399999999999998,16,106,122
0,8,10,0.74,0.6970000000000001,0.2537,37,92,129
0,6,5,0.62,0.5758,0.0,1,6,7
0,5,4,0.38,0.3939,0.3284,1,2,3
0,10,6,0.54,0.5152,0.2537,5,107,112
0,7,23,0.74,0.6970000000000001,0.2239,14,56,70
0,10,23,0.54,0.5152,0.1045,12,63,75
1,3,9,0.5,0.4848,0.1642,55,276,331
1,1,8,0.18,0.19699999999999998,0.1343,9,61,70
1,8,17,0.8,0.7121,0.1642,102,716,818
1,5,13,0.68,0.6364,0.2537,255,347,602
1,11,21,0.34,0.3333,0.19399999999999998,21,157,178
1,5,21,0.64,0.5909,0.1642,48,237,285
0,6,14,0.64,0.6212,0.19399999999999998,41,118,159
0,10,18,0.52,0.5,0.1642,55,398,453
0,3,7,0.2,0.1818,0.3284,6,104,110
0,1,21,0.14,0.1061,0.4179,1,19,20
1,10,6,0.5,0.4848,0.3284,7,32,39
0,10,22,0.5,0.4848,0.0,27,119,146
0,2,6,0.2,0.1818,0.3284,0,30,30
0,6,12,0.8,0.7576,0.2239,112,235,347
0,8,11,0.7,0.6515,0.3881,59,178,237
1,10,11,0.64,0.6061,0.2537,258,389,647
0,2,19,0.16,0.1212,0.4627,1,100,101
1,11,15,0.44,0.4394,0.4179,32,201,233
1,3,3,0.5,0.4848,0.0,0,7,7
1,10,8,0.62,0.5606,0.1045,28,781,809
1,11,12,0.32,0.3333,0.1343,31,217,248
0,6,18,0.76,0.6667,0.2537,114,472,586
0,3,14,0.54,0.5152,0.2239,36,65,101
0,9,23,0.56,0.5303,0.3881,3,17,20
1,5,5,0.6,0.5455,0.1642,1,29,30
1,4,3,0.5,0.4848,0.2239,4,25,29
0,3,2,0.3,0.2879,0.2537,0,6,6
1,7,15,0.92,0.8333,0.3582,71,183,254
0,5,13,0.5,0.4848,0.1642,123,209,332
0,11,8,0.3,0.2727,0.3582,9,249,258
1,2,14,0.44,0.4394,0.3284,35,142,177
0,10,21,0.52,0.5,0.0,54,133,187
1,4,12,0.54,0.5152,0.7164,94,186,280
0,3,23,0.3,0.2879,0.2537,3,34,37
0,10,10,0.52,0.5,0.0896,48,126,174
1,3,9,0.52,0.5,0.1343,96,153,249
1,12,7,0.34,0.303,0.4179,8,372,380
0,4,10,0.32,0.303,0.2836,12,63,75
0,11,17,0.5,0.4848,0.1642,39,489,528
1,8,8,0.66,0.6212,0.0,41,703,744
0,3,21,0.26,0.2576,0.1642,7,29,36
0,10,9,0.54,0.5152,0.4478,14,183,197
1,4,15,0.42,0.4242,0.19399999999999998,10,88,98
0,7,23,0.74,0.6667,0.0896,16,93,109
0,12,19,0.34,0.3485,0.1045,9,219,228
1,1,14,0.4,0.4091,0.1045,16,112,128
0,5,11,0.46,0.4545,0.1045,109,141,250
1,11,15,0.3,0.2879,0.2537,36,209,245
1,7,12,0.96,0.8636,0.3582,124,218,342
1,2,9,0.28,0.2576,0.3582,7,225,232
1,4,16,0.56,0.5303,0.2537,113,350,463
0,6,21,0.72,0.6515,0.1045,81,242,323
0,8,5,0.66,0.6061,0.1045,2,24,26
1,8,2,0.6,0.5606,0.1642,0,5,5
0,11,22,0.42,0.4242,0.2239,1,45,46
1,7,11,0.8,0.7273,0.19399999999999998,92,157,249
0,3,23,0.42,0.4242,0.2836,7,43,50
1,11,21,0.24,0.2121,0.2836,6,179,185
1,7,21,0.84,0.7424,0.1343,77,181,258
0,6,1,0.64,0.5758,0.1045,19,74,93
0,10,2,0.32,0.303,0.2836,1,3,4
1,2,0,0.3,0.2879,0.2239,2,21,23
1,5,22,0.62,0.5909,0.1642,26,116,142
0,11,9,0.42,0.4242,0.4627,15,239,254
1,5,5,0.54,0.5152,0.1045,4,34,38
1,11,7,0.24,0.2879,0.0,5,72,77
1,5,18,0.7,0.6515,0.4627,77,564,641
0,9,4,0.62,0.5909,0.1642,3,4,7
1,6,5,0.7,0.6667,0.1045,3,37,40
0,8,10,0.7,0.6364,0.2239,28,109,137
1,2,20,0.52,0.5,0.1642,10,254,264
0,9,5,0.6,0.5455,0.0896,1,2,3
1,12,15,0.42,0.4242,0.2836,28,209,237
1,4,7,0.44,0.4394,0.0,12,354,366
0,11,4,0.32,0.3485,0.0,2,4,6
0,3,15,0.34,0.303,0.3881,32,64,96
1,5,0,0.6,0.5758,0.1343,30,49,79
1,7,9,0.82,0.7879,0.0,51,168,219
1,4,23,0.46,0.4545,0.0,10,53,63
1,8,3,0.66,0.6212,0.0896,7,31,38
0,6,11,0.76,0.7273,0.2537,28,108,136
1,9,1,0.58,0.5455,0.3284,10,19,29
0,9,23,0.6,0.5455,0.0896,27,123,150
1,8,18,0.78,0.7273,0.1642,117,745,862
0,1,15,0.34,0.3333,0.1642,19,55,74
1,7,19,0.88,0.7879,0.2537,69,478,547
1,9,23,0.58,0.5455,0.1642,12,121,133
1,11,10,0.3,0.3333,0.0,10,159,169
0,9,0,0.64,0.6061,0.1343,3,34,37
1,3,18,0.44,0.4394,0.4478,90,594,684
1,5,11,0.66,0.6212,0.1343,61,160,221
0,4,13,0.54,0.5152,0.2836,22,84,106
1,2,15,0.32,0.303,0.2985,14,120,134
0,6,3,0.6,0.5455,0.0896,4,16,20
1,2,1,0.34,0.303,0.3582,4,42,46
1,8,7,0.7,0.6667,0.1343,21,481,502
0,9,19,0.64,0.5758,0.1343,87,242,329
0,11,3,0.38,0.3939,0.0896,0,11,11
0,9,21,0.72,0.6970000000000001,0.2537,104,103,207
0,2,10,0.22,0.1818,0.5522,4,44,48
1,9,21,0.6,0.6212,0.2239,57,149,206
0,1,6,0.22,0.2121,0.2239,0,35,35
0,1,14,0.22,0.19699999999999998,0.3881,3,39,42
1,7,12,0.7,0.6515,0.1045,178,326,504
1,9,7,0.56,0.5303,0.0,17,437,454
0,8,12,0.76,0.6818,0.3284,42,120,162
0,11,3,0.42,0.4242,0.3284,0,3,3
0,3,4,0.24,0.2576,0.0896,1,1,2
0,10,23,0.3,0.2727,0.3284,8,31,39
0,12,22,0.38,0.3939,0.1343,2,36,38
1,8,17,0.82,0.2424,0.3284,144,647,791
1,12,22,0.34,0.3333,0.0,5,127,132
1,2,5,0.4,0.4091,0.2239,2,30,32
1,2,12,0.4,0.4091,0.1343,27,201,228
1,10,22,0.5,0.4848,0.0896,14,176,190
1,3,18,0.46,0.4545,0.2239,27,110,137
0,11,8,0.3,0.3182,0.0896,4,42,46
1,3,20,0.28,0.2727,0.2537,8,80,88
0,7,16,0.76,0.7273,0.2537,57,218,275
1,1,2,0.3,0.2879,0.2239,0,2,2
0,12,15,0.38,0.3939,0.2537,26,105,131
0,3,4,0.18,0.1818,0.19399999999999998,1,0,1
0,12,17,0.36,0.3636,0.1045,19,377,396
1,2,14,0.3,0.303,0.1642,8,100,108
1,10,22,0.44,0.4394,0.3582,2,35,37
1,12,2,0.46,0.4545,0.1642,2,7,9
1,12,20,0.32,0.3485,0.0,28,170,198
1,5,9,0.56,0.5303,0.3582,37,258,295
0,6,12,0.62,0.6061,0.1045,33,129,162
1,4,6,0.4,0.4091,0.2537,5,115,120
0,9,3,0.62,0.5455,0.2537,1,1,2
0,6,16,0.8,0.7727,0.2239,62,273,335
0,11,1,0.26,0.2273,0.2985,1,34,35
1,12,23,0.42,0.4242,0.1045,9,93,102
1,8,11,0.76,0.7273,0.1343,108,152,260
0,6,13,0.76,0.6970000000000001,0.0,135,192,327
1,7,0,0.62,0.5758,0.2836,11,92,103
0,2,8,0.42,0.4242,0.19399999999999998,26,246,272
1,1,19,0.32,0.3182,0.19399999999999998,8,104,112
1,6,0,0.66,0.6212,0.1045,33,125,158
0,3,7,0.22,0.19699999999999998,0.3582,5,128,133
1,4,17,0.56,0.5303,0.1642,66,617,683
0,12,21,0.5,0.4848,0.2836,9,114,123
0,12,19,0.22,0.2273,0.19399999999999998,7,98,105
0,2,5,0.46,0.4545,0.1045,1,6,7
0,5,22,0.52,0.5,0.1045,29,121,150
1,9,0,0.74,0.6818,0.1045,22,146,168
1,4,4,0.36,0.3636,0.1045,5,9,14
0,4,23,0.54,0.5152,0.1642,31,86,117
0,12,21,0.28,0.2879,0.1343,8,60,68
1,6,0,0.56,0.5303,0.1343,5,81,86
0,10,14,0.52,0.5,0.2985,67,131,198
1,10,7,0.64,0.5758,0.0896,12,379,391
0,9,10,0.68,0.6364,0.1343,42,93,135
1,9,7,0.7,0.6667,0.2537,11,489,500
0,4,8,0.36,0.3333,0.2537,15,32,47
0,4,19,0.54,0.5152,0.0,37,222,259
0,7,0,0.76,0.7424,0.19399999999999998,13,29,42
0,6,18,0.7,0.6364,0.2985,76,488,564
0,6,15,0.8,0.6818,0.3881,44,144,188
0,8,16,0.86,0.7424,0.2985,76,206,282
0,9,2,0.44,0.4394,0.2537,21,68,89
1,6,3,0.52,0.5,0.2239,1,3,4
1,3,17,0.36,0.3788,0.0,104,250,354
1,6,0,0.7,0.6515,0.2239,2,26,28
0,5,1,0.62,0.5606,0.1642,17,49,66
1,10,3,0.38,0.3939,0.0896,12,29,41
1,9,12,0.8,0.7576,0.1642,187,284,471
0,8,3,0.64,0.5909,0.0,1,4,5
0,6,22,0.62,0.6212,0.2239,20,114,134
1,9,11,0.68,0.6364,0.1045,84,196,280
0,11,10,0.48,0.4697,0.1343,21,86,107
1,10,0,0.56,0.5303,0.0,1,30,31
0,3,5,0.24,0.2273,0.19399999999999998,0,11,11
1,1,4,0.22,0.2424,0.1045,0,4,4
0,6,4,0.56,0.5303,0.1045,0,6,6
1,10,18,0.54,0.5152,0.1045,60,726,786
1,12,11,0.4,0.4091,0.2985,40,210,250
1,7,1,0.72,0.6667,0.0,5,9,14
1,7,19,0.78,0.6970000000000001,0.1343,71,510,581
1,3,13,0.6,0.5758,0.19399999999999998,77,207,284
1,6,15,0.66,0.6212,0.2985,77,215,292
0,12,23,0.3,0.303,0.1343,12,73,85
1,1,3,0.18,0.1667,0.2836,1,20,21
0,10,16,0.7,0.6364,0.0896,154,248,402
0,7,15,0.8,0.7879,0.3582,39,102,141
0,12,18,0.26,0.2273,0.3881,7,150,157
1,7,7,0.74,0.6818,0.2836,23,450,473
1,9,7,0.64,0.5758,0.4478,13,343,356
1,3,19,0.4,0.4091,0.2239,42,353,395
0,8,13,0.9,0.8029999999999999,0.2985,38,112,150
1,5,2,0.6,0.5758,0.1642,8,8,16
0,11,20,0.4,0.4091,0.0896,19,76,95
0,9,17,0.68,0.6364,0.1642,78,377,455
0,2,23,0.32,0.2879,0.3881,0,45,45
0,5,0,0.42,0.4242,0.1343,10,76,86
0,9,22,0.64,0.6061,0.1642,33,114,147
1,2,3,0.44,0.4394,0.19399999999999998,2,4,6
0,11,17,0.48,0.4697,0.19399999999999998,17,216,233
1,7,21,0.76,0.7121,0.19399999999999998,45,251,296
0,9,5,0.6,0.5606,0.1343,15,24,39
1,2,22,0.4,0.4091,0.5821,4,102,106
1,5,17,0.64,0.6061,0.2836,77,640,717
1,6,14,0.88,0.8029999999999999,0.19399999999999998,56,134,190
1,7,16,0.9,0.7727,0.19399999999999998,90,437,527
0,8,16,0.72,0.7121,0.0,16,105,121
1,3,9,0.44,0.4394,0.0896,104,217,321
0,5,9,0.46,0.4545,0.2836,27,161,188
0,4,22,0.62,0.5606,0.3284,18,111,129
0,4,16,0.6,0.6212,0.0,52,161,213
0,5,1,0.5,0.4848,0.1343,18,64,82
1,9,14,0.82,0.7727,0.4478,260,366,626
1,1,15,0.2,0.19699999999999998,0.19399999999999998,6,113,119
1,9,7,0.5,0.4848,0.1045,24,572,596
0,7,10,0.8,0.7576,0.2836,30,86,116
0,8,7,0.64,0.6061,0.2537,18,328,346
0,6,5,0.68,0.6364,0.1343,4,12,16
1,9,15,0.66,0.6212,0.3284,56,247,303
0,12,0,0.28,0.2576,0.3284,1,19,20
1,9,20,0.52,0.5,0.1642,31,378,409
1,10,23,0.48,0.4697,0.0896,8,76,84
1,9,16,0.74,0.6970000000000001,0.0,222,252,474
1,10,12,0.54,0.5152,0.3284,236,439,675
0,10,4,0.36,0.3485,0.1642,0,6,6
1,6,22,0.62,0.6212,0.2985,91,189,280
1,1,16,0.22,0.2576,0.0896,3,46,49
0,7,0,0.76,0.6970000000000001,0.19399999999999998,60,73,133
1,8,23,0.7,0.6515,0.2239,28,100,128
0,7,12,0.88,0.8939,0.3284,29,106,135
0,3,14,0.5,0.4848,0.1045,32,87,119
0,9,8,0.62,0.5455,0.0,29,326,355
0,3,8,0.3,0.2727,0.4179,3,95,98
0,8,12,0.72,0.6515,0.0,65,172,237
1,12,0,0.46,0.4545,0.4627,2,29,31
0,7,13,0.8,0.7727,0.2239,248,173,421
1,10,1,0.58,0.5455,0.0,6,22,28
0,5,2,0.62,0.5758,0.1045,7,7,14
0,9,21,0.64,0.5909,0.1642,45,200,245
1,12,16,0.34,0.303,0.3284,21,281,302
1,3,7,0.3,0.2727,0.2985,2,21,23
0,8,16,0.74,0.6970000000000001,0.1642,116,176,292
1,4,6,0.36,0.3485,0.1343,9,88,97
0,4,2,0.44,0.4394,0.2239,12,53,65
0,10,1,0.4,0.4091,0.19399999999999998,20,50,70
0,12,4,0.46,0.4545,0.1642,0,1,1
0,1,22,0.16,0.19699999999999998,0.0896,4,28,32
0,12,15,0.34,0.303,0.3582,60,239,299
1,6,0,0.76,0.7273,0.1045,16,77,93
0,2,4,0.12,0.1667,0.0896,0,4,4
0,9,8,0.62,0.5758,0.1642,33,396,429
1,7,2,0.76,0.7121,0.1343,4,13,17
0,1,11,0.2,0.2121,0.1343,4,31,35
1,6,9,0.64,0.5758,0.1642,41,234,275
0,3,10,0.3,0.2879,0.19399999999999998,25,46,71
1,9,3,0.6,0.5606,0.1343,0,7,7
0,11,4,0.28,0.2576,0.3284,3,5,8
0,10,10,0.46,0.4545,0.1642,32,106,138
0,12,16,0.42,0.4242,0.0896,22,254,276
0,5,21,0.6,0.5909,0.1045,54,178,232
0,2,10,0.44,0.4394,0.2239,9,46,55
1,1,21,0.26,0.2727,0.1343,9,88,97
1,6,2,0.52,0.5,0.0896,0,12,12
0,5,1,0.34,0.3333,0.19399999999999998,4,6,10
0,8,11,0.74,0.6970000000000001,0.19399999999999998,122,192,314
0,6,18,0.62,0.6212,0.3284,65,473,538
1,5,1,0.58,0.5455,0.3582,4,11,15
1,12,16,0.3,0.2424,0.1045,22,125,147
0,9,19,0.64,0.5758,0.0896,32,388,420
1,7,21,0.66,0.6061,0.0896,94,206,300
1,4,7,0.42,0.4242,0.19399999999999998,11,320,331
0,12,6,0.22,0.2576,0.0896,1,62,63
0,8,6,0.56,0.5303,0.0,3,105,108
0,1,13,0.2,0.1818,0.2836,9,64,73
0,7,10,0.76,0.6970000000000001,0.1343,95,173,268
1,8,5,0.6,0.5758,0.2537,2,7,9
0,2,17,0.34,0.3485,0.1642,60,86,146
1,11,21,0.3,0.2727,0.3582,9,178,187
0,3,23,0.28,0.2576,0.2985,1,18,19
1,6,10,0.64,0.6061,0.0896,44,136,180
0,7,10,0.74,0.6970000000000001,0.1642,131,133,264
0,12,21,0.3,0.303,0.1642,5,134,139
1,4,21,0.52,0.5,0.2239,28,222,250
0,4,21,0.66,0.6212,0.2537,39,119,158
1,10,9,0.5,0.4848,0.2985,26,374,400
0,12,20,0.22,0.2121,0.2537,7,99,106
0,10,15,0.36,0.3333,0.2537,44,171,215
0,11,5,0.38,0.3939,0.1642,1,17,18
1,4,3,0.42,0.4242,0.1343,8,18,26
1,12,21,0.24,0.2424,0.1343,17,75,92
0,5,17,0.84,0.8029999999999999,0.2239,67,428,495
0,3,9,0.3,0.303,0.1343,35,43,78
1,1,14,0.5,0.4848,0.3284,18,142,160
0,12,13,0.42,0.4242,0.0896,18,153,171
0,7,2,0.8,0.7879,0.0896,12,48,60
0,11,8,0.54,0.5152,0.1045,27,453,480
0,7,18,0.72,0.6515,0.2239,102,394,496
0,10,2,0.44,0.4394,0.1642,2,1,3
1,1,5,0.28,0.2879,0.1045,0,5,5
1,3,4,0.24,0.2424,0.1343,7,15,22
1,2,6,0.3,0.2727,0.3284,1,100,101
0,1,8,0.16,0.1818,0.1045,0,15,15
1,6,6,0.6,0.5455,0.1343,6,130,136
1,10,23,0.46,0.4545,0.2239,9,72,81
1,7,0,0.68,0.6364,0.0,1,55,56
1,2,8,0.3,0.3182,0.0,7,522,529
0,7,16,0.86,0.7273,0.1642,40,228,268
1,6,22,0.6,0.6212,0.1642,35,193,228
0,12,0,0.4,0.4091,0.19399999999999998,2,7,9
0,3,21,0.36,0.3485,0.2239,1,27,28
0,1,1,0.16,0.1818,0.1045,0,2,2
1,8,1,0.74,0.6970000000000001,0.2537,8,79,87
1,12,7,0.2,0.1818,0.3284,0,26,26
1,12,21,0.36,0.3788,0.0,14,92,106
0,5,22,0.54,0.5152,0.2836,12,86,98
0,2,5,0.2,0.2576,0.0,1,9,10
1,3,1,0.42,0.4242,0.2537,24,65,89
1,11,2,0.32,0.3333,0.0896,0,5,5
0,4,10,0.42,0.4242,0.2239,36,93,129
0,1,23,0.2,0.2273,0.1045,0,18,18
1,12,10,0.26,0.2121,0.5821,31,91,122
1,10,22,0.44,0.4394,0.1045,47,155,202
1,8,17,0.64,0.5758,0.2239,61,172,233
1,8,3,0.68,0.6364,0.19399999999999998,0,3,3
1,1,23,0.3,0.2727,0.3284,4,21,25
0,2,18,0.16,0.1818,0.1343,3,157,160
1,12,3,0.26,0.2273,0.4179,1,14,15
1,4,8,0.4,0.4091,0.2537,8,43,51
1,5,11,0.66,0.6212,0.2836,50,179,229
0,5,3,0.52,0.5,0.2985,6,3,9
0,7,14,0.9,0.7879,0.0,112,193,305
1,10,19,0.5,0.4848,0.1343,77,268,345
0,9,0,0.64,0.6061,0.1045,22,65,87
0,9,11,0.68,0.6364,0.1343,39,120,159
1,2,4,0.22,0.19699999999999998,0.4478,0,1,1
0,12,11,0.36,0.3333,0.3582,18,93,111
0,7,16,0.84,0.8029999999999999,0.2836,45,220,265
0,3,3,0.28,0.2727,0.2239,1,2,3
1,5,5,0.56,0.5303,0.19399999999999998,0,24,24
1,12,11,0.4,0.4091,0.0896,22,148,170
1,10,4,0.54,0.5152,0.2537,4,7,11
0,9,6,0.62,0.5455,0.1045,8,116,124
1,10,4,0.54,0.5152,0.0,0,11,11
1,4,6,0.5,0.4848,0.2836,6,128,134
0,5,8,0.62,0.5909,0.19399999999999998,27,75,102
0,5,8,0.56,0.5303,0.2985,28,366,394
1,5,3,0.52,0.5,0.2836,2,4,6
1,5,21,0.68,0.6364,0.1642,41,318,359
1,11,6,0.38,0.3939,0.1045,7,64,71
0,8,0,0.66,0.6212,0.0896,8,16,24
0,11,8,0.28,0.2576,0.3284,4,80,84
0,6,10,0.8,0.7424,0.1642,45,112,157
1,9,3,0.48,0.4697,0.2985,13,41,54
0,3,19,0.38,0.3939,0.2537,12,147,159
1,10,0,0.46,0.4545,0.19399999999999998,4,53,57
0,3,16,0.5,0.4848,0.3881,175,129,304
0,1,20,0.24,0.2273,0.19399999999999998,1,61,62
1,11,9,0.34,0.3485,0.1045,27,355,382
0,9,12,0.72,0.6667,0.2239,43,144,187
1,8,19,0.62,0.5909,0.1045,56,420,476
0,4,9,0.46,0.4545,0.4925,4,50,54
1,1,19,0.16,0.1818,0.1045,9,80,89
0,8,6,0.72,0.6818,0.4925,9,101,110
1,12,14,0.36,0.3788,0.0,110,369,479
1,7,3,0.66,0.6212,0.2239,18,37,55
0,6,9,0.68,0.6364,0.1045,58,111,169
0,3,9,0.28,0.2576,0.3881,16,156,172
1,7,7,0.7,0.6667,0.2537,17,478,495
0,10,6,0.4,0.4091,0.0,5,15,20
1,1,19,0.12,0.0909,0.4179,4,152,156
0,11,20,0.4,0.4091,0.0,17,187,204
1,5,0,0.58,0.5455,0.1045,42,128,170
1,11,18,0.46,0.4545,0.0,50,158,208
1,2,10,0.12,0.1061,0.3582,8,83,91
1,7,0,0.72,0.7121,0.1045,10,43,53
0,4,6,0.42,0.4242,0.1642,2,62,64
1,6,9,0.7,0.6515,0.19399999999999998,37,231,268
0,7,16,0.86,0.7727,0.2239,47,218,265
1,11,16,0.42,0.4242,0.2537,55,325,380
1,9,19,0.7,0.6515,0.1642,38,589,627
1,9,17,0.64,0.6212,0.2239,91,885,976
0,4,2,0.36,0.3333,0.2985,2,7,9
1,12,7,0.34,0.3636,0.0,9,387,396
0,9,1,0.62,0.5606,0.1045,3,14,17
0,12,23,0.2,0.2273,0.0,6,63,69
1,11,13,0.38,0.3939,0.1045,20,197,217
1,5,21,0.76,0.7273,0.2836,66,181,247
1,1,19,0.34,0.3485,0.0896,10,255,265
1,11,12,0.4,0.4091,0.1642,117,359,476
1,6,20,0.56,0.5303,0.2239,44,371,415
0,6,23,0.62,0.6212,0.19399999999999998,14,75,89
1,11,22,0.32,0.3333,0.1045,15,130,145
0,3,20,0.44,0.4394,0.3284,12,58,70
1,8,7,0.64,0.5758,0.1045,5,128,133
0,5,12,0.6,0.6212,0.19399999999999998,129,244,373
0,5,16,0.8,0.7424,0.3582,58,233,291
1,2,6,0.36,0.3788,0.0,1,73,74
0,9,2,0.56,0.5303,0.0,2,0,2
1,6,19,0.84,0.7273,0.2985,79,492,571
0,11,19,0.6,0.6212,0.2985,28,274,302
0,6,6,0.68,0.6364,0.0896,7,121,128
1,5,9,0.56,0.5303,0.0,26,289,315
0,9,3,0.68,0.6364,0.2985,4,12,16
0,7,5,0.64,0.6061,0.2239,4,8,12
1,11,4,0.3,0.3182,0.1045,0,5,5
0,4,13,0.56,0.5303,0.2239,38,121,159
1,6,7,0.52,0.5,0.1045,9,77,86
1,8,5,0.66,0.6061,0.0896,3,39,42
1,9,2,0.46,0.4545,0.0896,2,9,11
1,3,8,0.28,0.2576,0.2985,12,554,566
0,2,19,0.44,0.4394,0.6119,1,79,80
1,1,13,0.3,0.2879,0.19399999999999998,15,117,132
0,12,14,0.32,0.3333,0.1343,16,95,111
1,12,1,0.4,0.4091,0.1045,17,85,102
0,11,4,0.36,0.3485,0.1343,1,5,6
0,6,15,0.82,0.7424,0.3284,56,127,183
0,12,10,0.4,0.4091,0.0896,13,128,141
0,4,18,0.34,0.303,0.3284,36,205,241
1,4,5,0.54,0.5152,0.2239,4,34,38
0,1,1,0.04,0.0455,0.19399999999999998,0,1,1
1,6,11,0.9,0.8485,0.2836,51,137,188
1,1,4,0.2,0.2121,0.1343,0,5,5
1,1,5,0.32,0.303,0.3284,0,13,13
0,12,21,0.36,0.3485,0.1343,15,112,127
0,1,17,0.14,0.1212,0.2537,6,178,184
1,5,7,0.56,0.5303,0.2985,7,146,153
0,2,11,0.22,0.1818,0.4627,1,49,50
1,2,8,0.24,0.2273,0.2239,13,495,508
0,2,8,0.24,0.19699999999999998,0.4925,7,236,243
0,11,6,0.56,0.5303,0.0896,4,104,108
0,9,4,0.5,0.4848,0.1642,2,6,8
0,11,4,0.3,0.3182,0.0896,1,1,2
0,12,4,0.22,0.2727,0.0,1,1,2
0,11,4,0.32,0.3333,0.0896,1,3,4
1,7,13,0.8,0.7121,0.1642,65,208,273
1,3,3,0.36,0.3485,0.1343,5,21,26
1,11,7,0.3,0.2879,0.2537,8,453,461
0,11,23,0.46,0.4545,0.1045,14,66,80
1,2,4,0.3,0.3182,0.0896,0,3,3
1,5,9,0.6,0.5758,0.0,32,262,294
0,2,17,0.32,0.2727,0.7463,8,181,189
0,7,5,0.72,0.7121,0.0896,2,22,24
0,5,15,0.64,0.6212,0.0896,28,152,180
1,9,16,0.64,0.6212,0.1642,194,402,596
0,12,12,0.46,0.4545,0.4925,17,140,157
0,4,19,0.42,0.4242,0.3881,41,168,209
0,7,12,0.96,0.8636,0.2836,40,95,135
1,12,18,0.38,0.3939,0.1045,25,473,498
0,3,22,0.32,0.3182,0.1642,6,38,44
1,1,22,0.3,0.2727,0.3582,4,39,43
0,11,16,0.4,0.4091,0.2239,5,146,151
0,1,4,0.26,0.2576,0.1642,0,1,1
1,12,23,0.26,0.2273,0.2985,2,8,10
1,9,13,0.68,0.6364,0.19399999999999998,327,377,704
1,1,9,0.2,0.2273,0.0896,13,198,211
0,1,2,0.1,0.0606,0.4627,0,11,11
1,5,6,0.62,0.5606,0.19399999999999998,6,25,31
1,5,22,0.62,0.5909,0.0896,17,157,174
0,10,8,0.44,0.4394,0.19399999999999998,26,438,464
1,2,6,0.28,0.303,0.0896,4,100,104
0,3,8,0.42,0.4242,0.2537,24,256,280
0,11,11,0.36,0.3636,0.1045,69,169,238
1,1,0,0.22,0.2424,0.1045,0,14,14
0,7,6,0.64,0.5758,0.1045,10,95,105
1,7,19,0.8,0.7879,0.1343,92,503,595
0,6,10,0.7,0.6515,0.1045,86,158,244
1,7,9,0.72,0.6515,0.2985,65,277,342
1,8,8,0.68,0.2424,0.1343,43,625,668
1,8,1,0.72,0.6970000000000001,0.0896,1,10,11
0,4,7,0.38,0.3939,0.0,11,182,193
1,10,14,0.62,0.6212,0.2985,94,191,285
0,4,5,0.46,0.4545,0.19399999999999998,1,17,18
0,3,1,0.3,0.303,0.0896,4,6,10
0,2,22,0.2,0.1667,0.4179,0,11,11
0,1,20,0.12,0.1212,0.2537,0,28,28
0,7,20,0.76,0.7121,0.3582,61,224,285
0,7,16,0.66,0.5909,0.0,23,118,141
1,3,8,0.22,0.2273,0.1343,4,68,72
0,2,14,0.22,0.2273,0.19399999999999998,9,49,58
0,1,5,0.16,0.1364,0.2836,0,3,3
0,9,15,0.66,0.6212,0.1343,168,284,452
0,9,15,0.66,0.6212,0.1045,43,142,185
0,4,12,0.52,0.5,0.4179,94,197,291
0,6,3,0.68,0.6364,0.1642,3,3,6
1,6,18,0.72,0.6515,0.2239,121,572,693
1,11,2,0.3,0.2879,0.2239,1,5,6
1,10,13,0.58,0.5455,0.1343,77,260,337
1,3,12,0.48,0.4697,0.5224,63,216,279
1,3,22,0.24,0.2121,0.3284,2,76,78
1,12,3,0.26,0.303,0.0,4,21,25
0,4,15,0.6,0.6212,0.0896,57,85,142
1,7,1,0.66,0.5909,0.1343,2,9,11
1,12,3,0.4,0.4091,0.1045,14,34,48
1,10,10,0.54,0.5152,0.0,50,171,221
0,2,12,0.36,0.3333,0.3582,10,85,95
0,5,21,0.54,0.5152,0.0,30,173,203
1,9,11,0.64,0.6212,0.0896,60,187,247
0,9,18,0.72,0.6667,0.19399999999999998,119,241,360
0,1,12,0.22,0.2121,0.2985,13,48,61
0,5,18,0.6,0.5909,0.2985,54,426,480
0,5,14,0.9,0.8182,0.0,41,99,140
0,10,8,0.54,0.5152,0.4925,10,200,210
1,6,4,0.54,0.5152,0.2836,2,11,13
1,12,9,0.24,0.2424,0.1343,13,330,343
0,7,1,0.66,0.5909,0.19399999999999998,2,14,16
1,10,12,0.54,0.5152,0.4627,75,312,387
0,10,1,0.4,0.4091,0.2239,7,19,26
0,11,14,0.42,0.4242,0.0896,4,31,35
0,7,20,0.76,0.7121,0.2239,129,185,314
1,5,12,0.7,0.6515,0.0,33,220,253
0,5,13,0.56,0.5303,0.3284,31,141,172
1,3,6,0.46,0.4545,0.2537,3,114,117
0,11,17,0.46,0.4545,0.1045,27,458,485
1,6,15,0.74,0.6667,0.2985,111,213,324
1,9,7,0.68,0.6364,0.1045,13,480,493
1,5,17,0.62,0.6061,0.1343,195,316,511
1,12,20,0.22,0.19699999999999998,0.3284,9,63,72
0,1,20,0.4,0.4091,0.2537,11,25,36
0,9,21,0.64,0.6061,0.0,45,114,159
0,3,9,0.32,0.303,0.2239,15,48,63
0,7,10,0.82,0.7879,0.1642,29,112,141
0,3,1,0.24,0.2273,0.19399999999999998,3,15,18
1,12,22,0.38,0.3939,0.1045,23,137,160
1,2,6,0.24,0.19699999999999998,0.4179,1,9,10
0,7,7,0.64,0.6061,0.0,10,35,45
0,4,23,0.44,0.4394,0.0896,25,88,113
0,3,5,0.36,0.3485,0.19399999999999998,1,2,3
0,4,21,0.34,0.2879,0.5224,8,81,89
0,9,12,0.56,0.5303,0.1642,13,47,60
1,3,6,0.36,0.3485,0.1642,7,16,23
1,12,18,0.4,0.4091,0.1045,40,264,304
1,10,10,0.52,0.5,0.2239,60,158,218
1,12,5,0.16,0.1515,0.19399999999999998,0,9,9
0,5,3,0.44,0.4394,0.0,1,4,5
0,4,2,0.38,0.3939,0.2537,1,1,2
0,4,13,0.36,0.3788,0.0,114,108,222
1,6,20,0.86,0.7879,0.19399999999999998,79,357,436
1,12,23,0.24,0.2273,0.2537,2,24,26
0,12,10,0.24,0.2273,0.19399999999999998,12,96,108
0,7,6,0.72,0.7121,0.0896,7,100,107
0,4,14,0.52,0.5,0.5821,14,49,63
0,11,23,0.4,0.4091,0.0896,15,80,95
0,1,8,0.06,0.0758,0.1642,2,17,19
1,4,15,0.36,0.3333,0.3881,11,101,112
1,8,16,0.8,0.7273,0.1642,77,405,482
1,6,23,0.62,0.6212,0.2537,46,176,222
0,9,18,0.72,0.6818,0.1642,83,503,586
1,5,12,0.72,0.6818,0.1045,84,237,321
0,11,17,0.52,0.5,0.3284,44,187,231
1,7,0,0.66,0.6061,0.1343,6,38,44
1,4,17,0.66,0.6212,0.2985,99,645,744
1,4,22,0.34,0.303,0.3284,4,130,134
1,8,18,0.76,0.7121,0.1642,103,711,814
1,9,2,0.62,0.5758,0.0896,1,10,11
1,1,4,0.36,0.3485,0.19399999999999998,0,2,2
1,2,7,0.24,0.2576,0.0896,4,276,280
0,5,0,0.46,0.4545,0.2239,5,39,44
0,8,19,0.72,0.6970000000000001,0.1045,55,235,290
1,5,21,0.66,0.6212,0.4179,64,79,143
1,6,19,0.7,0.6364,0.2836,65,537,602
1,7,1,0.74,0.6667,0.2836,6,24,30
0,7,19,0.78,0.6667,0.19399999999999998,80,238,318
1,1,15,0.22,0.2121,0.2239,10,64,74
0,10,16,0.62,0.6212,0.2537,58,246,304
1,1,21,0.24,0.2121,0.2836,7,95,102
0,3,19,0.42,0.4242,0.0896,26,86,112
1,7,0,0.66,0.5909,0.1343,59,129,188
0,10,23,0.36,0.3485,0.19399999999999998,6,46,52
0,3,1,0.26,0.2879,0.0896,0,1,1
0,6,20,0.66,0.6212,0.2239,52,264,316
1,5,1,0.6,0.5455,0.0896,9,21,30
1,4,10,0.48,0.4697,0.0896,46,143,189
1,5,4,0.56,0.5303,0.19399999999999998,0,4,4
1,4,1,0.54,0.5152,0.1642,17,89,106
1,3,14,0.42,0.4242,0.4627,49,129,178
1,4,16,0.3,0.2727,0.3582,10,93,103
1,3,0,0.32,0.2879,0.5224,1,9,10
0,6,23,0.66,0.6212,0.2985,49,130,179
0,10,13,0.56,0.5303,0.1045,20,62,82
1,11,16,0.34,0.3333,0.1642,33,369,402
0,7,3,0.68,0.6364,0.1343,2,2,4
0,4,11,0.36,0.3636,0.0,51,91,142
0,1,2,0.24,0.2424,0.1642,0,2,2
1,3,14,0.48,0.4697,0.4478,58,159,217
0,1,3,0.1,0.1364,0.1045,0,1,1
0,4,20,0.58,0.5455,0.2239,49,220,269
1,2,3,0.26,0.303,0.0,0,1,1
0,12,13,0.4,0.4091,0.2239,88,269,357
1,4,3,0.32,0.303,0.2239,0,2,2
0,7,16,0.7,0.6667,0.2239,37,161,198
0,11,4,0.3,0.2879,0.2239,0,5,5
0,9,9,0.56,0.5303,0.19399999999999998,23,214,237
0,11,3,0.38,0.3939,0.1642,1,7,8
0,9,12,0.66,0.5909,0.1343,33,129,162
0,2,18,0.3,0.303,0.1642,13,65,78
1,11,0,0.28,0.2727,0.2239,1,14,15
0,12,19,0.5,0.4848,0.3284,9,200,209
0,11,23,0.36,0.3788,0.0,18,51,69
1,4,8,0.34,0.3182,0.2537,29,94,123
1,6,14,0.8,0.6818,0.3582,78,192,270
1,10,13,0.6,0.6212,0.1642,80,225,305
0,12,8,0.26,0.303,0.0,9,458,467
0,1,17,0.24,0.2879,0.0,9,82,91
0,9,7,0.5,0.4848,0.2239,20,312,332
0,3,11,0.44,0.4394,0.4179,88,93,181
1,10,3,0.62,0.5606,0.0,5,6,11
0,2,22,0.22,0.2121,0.2537,5,35,40
0,1,12,0.2,0.1515,0.5821,3,52,55
0,10,8,0.4,0.4091,0.0,26,88,114
0,12,10,0.3,0.2576,0.4925,4,52,56
0,6,6,0.6,0.6061,0.0,7,13,20
0,1,13,0.08,0.1667,0.0,12,72,84
0,3,2,0.22,0.2273,0.19399999999999998,0,2,2
1,6,11,0.66,0.6212,0.4478,64,182,246
0,10,0,0.5,0.4848,0.0,11,42,53
1,4,17,0.36,0.3182,0.4478,2,25,27
0,1,19,0.22,0.2576,0.0896,3,109,112
0,3,20,0.3,0.2879,0.19399999999999998,9,78,87
0,8,10,0.7,0.6515,0.2836,36,85,121
0,5,12,0.76,0.6818,0.3881,41,129,170
1,5,15,0.64,0.6212,0.2537,83,233,316
0,4,0,0.6,0.5606,0.2239,3,24,27
0,7,14,0.76,0.7273,0.2836,50,113,163
1,9,5,0.58,0.5455,0.5224,1,15,16
0,6,18,0.72,0.6515,0.1343,80,527,607
0,6,14,0.82,0.7727,0.1045,148,232,380
1,2,11,0.4,0.4091,0.1642,27,116,143
1,2,0,0.32,0.3485,0.0,0,22,22
1,9,9,0.52,0.5,0.1045,74,211,285
1,12,13,0.34,0.3636,0.0,123,386,509
1,10,6,0.54,0.5152,0.2537,2,28,30
0,10,14,0.24,0.19699999999999998,0.4478,0,29,29
0,3,21,0.28,0.2727,0.1642,7,53,60
0,1,14,0.22,0.2727,0.0,2,36,38
0,7,11,0.82,0.7879,0.2985,39,89,128
1,7,21,0.72,0.6818,0.1343,72,199,271
1,4,20,0.56,0.5303,0.2239,52,352,404
1,7,19,0.76,0.7121,0.1642,109,523,632
1,11,2,0.26,0.2576,0.19399999999999998,8,41,49
0,1,19,0.24,0.2424,0.1343,5,84,89
1,3,2,0.42,0.4242,0.2985,6,29,35
1,12,11,0.4,0.4091,0.1045,63,341,404
0,1,16,0.2,0.2121,0.1642,5,82,87
0,7,20,0.82,0.8029999999999999,0.2239,47,98,145
0,7,18,0.82,0.7727,0.3582,80,478,558
0,9,11,0.74,0.6970000000000001,0.1642,174,163,337
1,4,12,0.5,0.4848,0.0,104,218,322
0,12,16,0.3,0.3333,0.0,32,174,206
0,9,16,0.56,0.5303,0.1642,134,235,369
0,10,1,0.46,0.4545,0.0,14,51,65
1,4,21,0.5,0.4848,0.1642,33,101,134
0,3,20,0.3,0.3182,0.0896,2,86,88
0,12,4,0.36,0.3788,0.0,0,2,2
0,1,18,0.2,0.2121,0.1642,11,56,67
1,9,22,0.7,0.6667,0.2239,52,247,299
1,9,15,0.68,0.6364,0.2836,104,288,392
0,11,10,0.34,0.3182,0.2836,62,170,232
1,7,9,0.84,0.8029999999999999,0.0,40,299,339
1,12,23,0.22,0.2273,0.19399999999999998,3,37,40
0,2,12,0.54,0.5152,0.4627,20,95,115
1,8,12,0.78,0.6818,0.0,97,235,332
0,3,18,0.44,0.4394,0.3582,2,80,82
1,1,20,0.26,0.2424,0.2836,2,88,90
0,10,5,0.54,0.5152,0.3284,0,22,22
0,1,14,0.2,0.2273,0.0896,3,60,63
1,7,12,0.92,0.8939,0.19399999999999998,105,271,376
0,2,18,0.4,0.4091,0.19399999999999998,24,103,127
1,4,23,0.34,0.303,0.2985,9,52,61
0,11,7,0.34,0.3182,0.2836,4,164,168
1,5,17,0.76,0.7121,0.2836,124,529,653
0,6,20,0.64,0.6212,0.1642,57,236,293
0,4,5,0.36,0.3636,0.0896,0,4,4
0,12,14,0.4,0.4091,0.0896,67,178,245
0,9,20,0.62,0.5455,0.1642,6,83,89
0,7,4,0.7,0.6667,0.2537,7,4,11
1,7,10,0.74,0.6515,0.0,68,163,231
0,10,13,0.56,0.5303,0.0896,33,158,191
0,3,6,0.26,0.2576,0.2239,1,3,4
0,6,13,0.84,0.7576,0.0,33,156,189
0,6,8,0.72,0.6970000000000001,0.19399999999999998,37,417,454
0,4,14,0.5,0.4848,0.3881,68,160,228
0,9,22,0.54,0.5152,0.0896,9,75,84
1,7,11,0.86,0.8029999999999999,0.0,60,146,206
0,11,10,0.32,0.303,0.2537,56,171,227
1,10,13,0.72,0.6667,0.3284,63,231,294
1,5,20,0.74,0.6818,0.19399999999999998,103,152,255
1,7,12,0.9,0.8182,0.2239,114,319,433
1,12,3,0.3,0.3182,0.0896,1,3,4
1,5,11,0.7,0.6667,0.19399999999999998,208,312,520
1,4,14,0.58,0.5455,0.0,54,183,237
1,2,22,0.24,0.2576,0.0896,4,91,95
1,2,21,0.32,0.3182,0.1642,11,143,154
1,8,21,0.74,0.6818,0.2239,56,252,308
0,7,17,0.66,0.5909,0.4478,6,161,167
0,4,12,0.38,0.3939,0.2239,29,51,80
0,11,2,0.36,0.3636,0.1045,9,48,57
1,11,12,0.28,0.2576,0.3881,6,70,76
1,11,19,0.26,0.303,0.0,13,114,127
1,4,16,0.68,0.6212,0.3582,50,320,370
0,6,15,0.9,0.8333,0.2985,25,127,152
1,5,18,0.58,0.5455,0.0,17,283,300
1,4,23,0.7,0.6364,0.2985,24,97,121
1,9,13,0.6,0.6212,0.1642,257,445,702
1,8,8,0.62,0.5909,0.1045,37,618,655
0,10,11,0.48,0.4697,0.5224,30,99,129
0,7,3,0.68,0.6364,0.0896,8,25,33
1,6,22,0.7,0.6515,0.1642,42,117,159
1,6,12,0.66,0.6212,0.2239,55,210,265
0,5,20,0.54,0.5152,0.1343,42,115,157
1,4,23,0.5,0.4848,0.1045,20,124,144
0,9,22,0.64,0.5909,0.0,49,126,175
0,9,11,0.62,0.5758,0.1642,42,138,180
0,7,0,0.66,0.6212,0.0,20,48,68
1,11,10,0.36,0.3788,0.0,22,150,172
0,3,13,0.3,0.2879,0.2239,47,100,147
0,2,14,0.2,0.1818,0.2985,2,56,58
1,9,18,0.64,0.6212,0.2239,64,758,822
0,10,17,0.5,0.4848,0.1343,120,220,340
0,3,15,0.36,0.3333,0.2985,15,64,79
1,4,12,0.48,0.4697,0.3881,36,188,224
0,9,1,0.6,0.5909,0.0896,7,14,21
0,8,15,0.76,0.6970000000000001,0.2537,50,160,210
1,8,17,0.74,0.6667,0.2239,117,695,812
1,8,0,0.7,0.6515,0.0,21,114,135
0,2,0,0.26,0.2424,0.2836,8,26,34
0,6,4,0.66,0.6212,0.19399999999999998,0,3,3
1,9,8,0.48,0.4697,0.1045,18,126,144
0,10,0,0.44,0.4394,0.19399999999999998,4,28,32
1,12,21,0.3,0.3333,0.0,23,135,158
1,1,13,0.4,0.4091,0.2985,77,266,343
1,4,7,0.34,0.3485,0.1045,16,368,384
1,12,23,0.34,0.3485,0.0896,1,80,81
0,2,10,0.42,0.4242,0.5821,34,72,106
1,11,14,0.4,0.4091,0.2985,125,303,428
0,4,5,0.46,0.4545,0.19399999999999998,1,12,13
1,9,19,0.5,0.4848,0.1343,34,223,257
0,10,4,0.44,0.4394,0.4179,2,6,8
0,5,1,0.42,0.4242,0.1045,9,50,59
0,10,18,0.36,0.3485,0.1642,36,332,368
1,1,15,0.52,0.5,0.2537,44,178,222
1,3,4,0.34,0.3333,0.19399999999999998,3,11,14
1,11,7,0.3,0.2879,0.19399999999999998,7,403,410
0,9,10,0.56,0.5303,0.1343,21,84,105
1,6,8,0.76,0.6970000000000001,0.1343,49,564,613
1,1,17,0.22,0.2576,0.0896,9,340,349
1,12,3,0.36,0.3333,0.2836,0,3,3
0,9,2,0.54,0.5152,0.0,1,5,6
1,8,7,0.7,0.6667,0.1642,24,451,475
0,11,18,0.52,0.5,0.3284,35,155,190
0,4,11,0.6,0.6212,0.3881,58,66,124
1,8,5,0.66,0.5909,0.1343,4,37,41
1,5,11,0.66,0.6212,0.3284,258,323,581
0,12,5,0.2,0.2273,0.1045,0,1,1
1,6,1,0.54,0.5152,0.1343,21,100,121
1,7,3,0.72,0.6818,0.0,0,3,3
0,9,1,0.6,0.5152,0.0896,5,6,11
1,9,4,0.42,0.4242,0.1343,2,7,9
0,3,2,0.56,0.5303,0.2239,5,20,25
1,2,7,0.08,0.0909,0.19399999999999998,0,18,18
1,7,22,0.76,0.7121,0.0896,56,228,284
1,8,19,0.74,0.6970000000000001,0.2239,74,499,573
1,3,20,0.44,0.4394,0.19399999999999998,31,80,111
0,10,2,0.52,0.5,0.19399999999999998,1,6,7
0,1,5,0.14,0.1515,0.1642,0,5,5
0,12,8,0.26,0.2273,0.3284,15,462,477
0,7,17,0.86,0.8485,0.4179,59,455,514
0,11,9,0.32,0.3485,0.0,25,70,95
1,3,15,0.64,0.6212,0.1343,357,322,679
0,2,12,0.5,0.4848,0.19399999999999998,59,126,185
1,6,18,0.62,0.5606,0.3582,10,100,110
1,7,9,0.8,0.7424,0.1642,46,226,272
1,10,8,0.36,0.3485,0.2239,23,374,397
0,10,2,0.56,0.5303,0.3881,4,3,7
0,2,2,0.12,0.1515,0.1343,0,1,1
1,11,19,0.3,0.2879,0.19399999999999998,18,326,344
0,8,23,0.68,0.6364,0.0896,4,52,56
0,6,6,0.5,0.4848,0.2537,11,110,121
0,7,23,0.68,0.6364,0.0896,44,96,140
1,2,5,0.4,0.4091,0.0,0,19,19
1,9,13,0.7,0.6667,0.5821,17,97,114
0,3,22,0.26,0.2576,0.1642,3,59,62
1,8,2,0.72,0.7121,0.1343,20,64,84
0,5,16,0.64,0.6212,0.2239,49,255,304
0,12,18,0.44,0.4394,0.0,13,386,399
0,12,21,0.36,0.3636,0.0896,4,139,143
0,6,16,0.76,0.6818,0.1642,69,286,355
0,4,13,0.68,0.6364,0.3284,47,92,139
1,5,1,0.7,0.6667,0.19399999999999998,1,13,14
1,4,14,0.64,0.6212,0.2836,59,198,257
1,12,21,0.36,0.3485,0.1343,15,169,184
0,6,0,0.62,0.5909,0.1343,11,18,29
0,8,8,0.64,0.5909,0.3284,29,326,355
1,11,22,0.32,0.3333,0.1045,13,133,146
1,5,11,0.56,0.5303,0.2537,88,203,291
1,10,19,0.64,0.6212,0.0896,50,522,572
1,7,15,0.86,0.7879,0.2239,81,242,323
0,7,2,0.74,0.6970000000000001,0.0896,19,48,67
0,7,2,0.7,0.6667,0.0,2,7,9
1,11,4,0.36,0.3485,0.2239,1,11,12
0,10,20,0.4,0.4091,0.0,13,191,204
0,10,20,0.42,0.4242,0.4925,11,171,182
0,10,16,0.48,0.4697,0.4478,31,203,234
1,11,8,0.24,0.2424,0.1343,20,77,97
0,5,4,0.4,0.4091,0.1045,1,4,5
1,4,7,0.34,0.303,0.3881,12,294,306
0,2,9,0.42,0.4242,0.19399999999999998,15,154,169
0,4,19,0.5,0.4848,0.2985,36,196,232
0,10,11,0.6,0.6212,0.2836,32,138,170
0,12,15,0.38,0.3939,0.2836,29,160,189
0,6,17,0.78,0.6818,0.2836,63,516,579
0,12,21,0.26,0.303,0.0,2,119,121
1,6,7,0.52,0.5,0.2239,10,135,145
1,12,17,0.36,0.3485,0.1343,20,209,229
1,6,3,0.5,0.4848,0.1045,0,5,5
0,3,2,0.34,0.3182,0.2239,1,1,2
0,8,0,0.68,0.6364,0.19399999999999998,9,53,62
0,2,0,0.26,0.2576,0.19399999999999998,2,37,39
0,10,3,0.3,0.2879,0.2836,4,4,8
1,10,19,0.56,0.5303,0.2985,42,471,513
0,1,2,0.26,0.2879,0.0896,3,13,16
1,11,9,0.3,0.2879,0.2836,18,239,257
1,8,15,0.76,0.6818,0.19399999999999998,96,242,338
0,11,6,0.38,0.3939,0.0896,2,64,66
1,12,3,0.26,0.2727,0.1343,1,14,15
1,9,2,0.54,0.5152,0.3284,0,3,3
1,5,2,0.6,0.6061,0.2985,1,1,2
1,7,17,0.82,0.7727,0.1343,87,760,847
0,11,1,0.46,0.4545,0.0896,0,5,5
1,11,18,0.4,0.4091,0.0,16,54,70
0,4,15,0.34,0.3182,0.2239,1,24,25
0,10,13,0.42,0.4242,0.1642,16,102,118
1,3,21,0.54,0.5152,0.1642,54,169,223
1,8,8,0.76,0.7273,0.3284,27,81,108
0,5,6,0.46,0.4545,0.1343,6,93,99
1,12,9,0.4,0.4091,0.0,11,271,282
1,12,7,0.36,0.3636,0.0896,3,36,39
1,12,17,0.52,0.5,0.2239,43,700,743
1,1,5,0.26,0.2727,0.1045,2,7,9
1,5,4,0.42,0.4242,0.19399999999999998,3,6,9
1,3,5,0.36,0.3636,0.0896,1,1,2
0,5,19,0.52,0.5,0.1045,68,157,225
0,7,21,0.74,0.6818,0.2239,59,148,207
0,8,19,0.7,0.6667,0.0,51,270,321
0,5,21,0.62,0.5909,0.19399999999999998,27,109,136
0,5,11,0.64,0.6212,0.0,56,129,185
1,10,20,0.4,0.4091,0.19399999999999998,9,259,268
1,8,16,0.84,0.7576,0.1045,88,363,451
0,11,19,0.38,0.3939,0.19399999999999998,21,130,151
0,9,21,0.6,0.5,0.1642,17,121,138
1,3,5,0.34,0.3333,0.19399999999999998,1,15,16
0,10,3,0.44,0.4394,0.2239,0,3,3
1,8,1,0.62,0.5909,0.0,1,20,21
1,1,13,0.42,0.4242,0.1642,13,170,183
1,9,11,0.64,0.6212,0.2537,46,181,227
1,7,2,0.64,0.5758,0.0,0,5,5
0,5,20,0.64,0.6061,0.1642,57,174,231
0,3,2,0.2,0.1667,0.4627,1,2,3
1,3,17,0.4,0.4091,0.2239,93,513,606
1,3,7,0.36,0.3485,0.1343,2,14,16
0,11,7,0.32,0.3333,0.0896,12,280,292
0,3,17,0.26,0.303,0.0,17,185,202
1,5,8,0.64,0.5909,0.1343,38,103,141
0,5,6,0.56,0.5303,0.0896,4,113,117
1,10,9,0.54,0.5152,0.1045,26,363,389
1,6,20,0.66,0.6212,0.2985,76,402,478
1,4,22,0.36,0.3485,0.1343,17,66,83
0,10,13,0.56,0.5303,0.0896,49,156,205
0,8,13,0.8,0.7727,0.4179,94,216,310
1,9,20,0.6,0.6212,0.2985,37,388,425
1,6,12,0.62,0.6212,0.3582,250,418,668
0,4,12,0.68,0.6364,0.2537,168,220,388
0,7,10,0.8,0.7121,0.0,103,168,271
1,9,8,0.72,0.6970000000000001,0.19399999999999998,33,692,725
0,12,15,0.46,0.4545,0.4925,89,164,253
1,8,17,0.8,0.7576,0.2836,107,751,858
0,9,9,0.64,0.5909,0.1642,19,183,202
0,6,15,0.82,0.7273,0.3881,69,147,216
1,4,11,0.64,0.6061,0.2537,115,136,251
0,5,2,0.5,0.4848,0.1343,3,8,11
1,4,2,0.44,0.4394,0.19399999999999998,3,18,21
1,7,16,0.8,0.7424,0.2836,88,337,425
0,7,9,0.8,0.7879,0.1343,22,177,199
0,10,10,0.52,0.5,0.2537,26,105,131
1,11,20,0.44,0.4394,0.0,39,153,192
0,12,21,0.22,0.2273,0.1343,7,63,70
0,10,8,0.34,0.3333,0.19399999999999998,14,50,64
0,8,20,0.72,0.6667,0.2985,45,289,334
0,6,2,0.62,0.6212,0.1343,2,6,8
1,4,18,0.54,0.5152,0.1343,107,564,671
1,4,11,0.38,0.3939,0.3284,38,142,180
0,9,1,0.62,0.5606,0.0,22,66,88
1,5,6,0.42,0.4242,0.0896,10,23,33
0,6,23,0.66,0.6212,0.0,27,99,126
0,3,13,0.4,0.4091,0.1343,18,81,99
0,7,12,0.92,0.8636,0.1045,71,164,235
0,9,12,0.56,0.5303,0.0,1,21,22
1,5,8,0.58,0.5455,0.0896,42,155,197
0,5,12,0.68,0.6364,0.3881,65,139,204
1,11,6,0.2,0.2576,0.0,2,104,106
0,1,12,0.22,0.19699999999999998,0.3284,7,41,48
0,5,10,0.54,0.5152,0.3284,30,97,127
0,7,1,0.64,0.5758,0.0896,43,76,119
1,2,8,0.28,0.2879,0.1045,2,114,116
1,4,6,0.44,0.4394,0.3284,6,6,12
0,4,1,0.32,0.3182,0.19399999999999998,5,11,16
1,4,19,0.6,0.5909,0.19399999999999998,42,501,543
0,12,3,0.18,0.2424,0.0,0,2,2
1,4,18,0.5,0.4848,0.3881,63,547,610
0,3,23,0.32,0.3333,0.0,2,24,26
0,4,10,0.36,0.3485,0.1642,41,113,154
1,9,5,0.48,0.4697,0.0896,1,44,45
1,2,7,0.4,0.4091,0.2239,7,265,272
1,1,13,0.46,0.4545,0.2239,27,171,198
0,3,12,0.38,0.3939,0.0,40,54,94
1,1,17,0.36,0.3485,0.19399999999999998,19,393,412
0,11,0,0.36,0.3333,0.4179,1,23,24
1,10,3,0.44,0.4394,0.1343,5,17,22
0,5,0,0.48,0.4697,0.0,6,12,18
0,4,9,0.5,0.4848,0.19399999999999998,16,162,178
0,8,8,0.68,0.6364,0.1642,27,94,121
0,4,14,0.34,0.3182,0.2537,3,33,36
0,4,1,0.54,0.5152,0.0896,2,8,10
1,3,15,0.52,0.5,0.3582,109,198,307
0,10,12,0.56,0.5303,0.2985,39,160,199
0,2,17,0.36,0.3485,0.19399999999999998,9,168,177
1,8,14,0.84,0.7424,0.3284,72,179,251
1,2,3,0.3,0.3333,0.0,1,1,2
0,2,3,0.12,0.1364,0.1642,0,2,2
0,3,15,0.68,0.6364,0.3582,62,111,173
1,1,19,0.42,0.4242,0.3881,20,85,105
0,2,2,0.22,0.19699999999999998,0.3582,3,9,12
1,10,13,0.66,0.6212,0.0,65,241,306
0,4,16,0.74,0.6667,0.3881,162,197,359
0,4,6,0.5,0.4848,0.2836,4,67,71
1,4,14,0.46,0.4545,0.1642,143,144,287
0,1,23,0.14,0.1061,0.4179,1,19,20
0,8,14,0.8,0.7727,0.0,55,164,219
1,1,2,0.32,0.303,0.2239,2,6,8
0,1,8,0.04,0.1364,0.0,6,171,177
0,2,11,0.24,0.2273,0.19399999999999998,5,47,52
0,11,18,0.46,0.4545,0.1343,24,409,433
1,3,15,0.72,0.6515,0.1343,191,281,472
0,9,7,0.46,0.4545,0.19399999999999998,4,33,37
1,12,3,0.16,0.1818,0.1045,0,1,1
1,1,20,0.16,0.1818,0.1045,10,85,95
1,10,6,0.34,0.3485,0.1045,5,54,59
0,8,18,0.74,0.6818,0.2985,102,519,621
1,7,17,0.78,0.6970000000000001,0.1642,108,741,849
0,9,19,0.66,0.5909,0.1642,33,316,349
0,6,2,0.68,0.6364,0.0896,13,59,72
0,3,10,0.26,0.2576,0.0,15,53,68
1,4,12,0.52,0.5,0.1343,24,180,204
0,11,6,0.34,0.3333,0.19399999999999998,3,96,99
0,1,7,0.2,0.2576,0.0,1,2,3
0,7,10,0.74,0.6970000000000001,0.3582,30,108,138
1,1,14,0.44,0.4394,0.2985,120,147,267
0,11,19,0.32,0.303,0.2836,6,273,279
0,3,16,0.3,0.2879,0.2537,13,72,85
0,11,19,0.42,0.4242,0.2537,32,139,171
1,1,16,0.18,0.1667,0.2836,8,123,131
1,5,13,0.6,0.5606,0.2537,49,135,184
0,6,13,0.7,0.6364,0.0,53,174,227
1,4,9,0.32,0.303,0.2985,20,282,302
0,8,16,0.86,0.7727,0.2836,64,218,282
0,6,12,0.76,0.6667,0.1642,25,128,153
0,1,3,0.18,0.19699999999999998,0.1642,0,7,7
0,2,14,0.28,0.2727,0.1642,15,76,91
1,3,14,0.58,0.5455,0.2836,76,145,221
0,12,12,0.26,0.303,0.0,42,246,288
0,5,15,0.66,0.6212,0.2537,206,253,459
0,10,19,0.58,0.5455,0.0896,69,267,336
0,1,6,0.16,0.1818,0.1343,0,27,27
1,9,8,0.56,0.5303,0.2836,33,697,730
0,5,16,0.6,0.6212,0.19399999999999998,119,223,342
1,12,13,0.32,0.303,0.2239,63,123,186
1,5,13,0.64,0.6212,0.1642,98,297,395
1,11,15,0.36,0.3182,0.4478,117,331,448
0,7,9,0.68,0.6364,0.19399999999999998,31,176,207
1,6,8,0.62,0.5606,0.2239,15,598,613
0,10,20,0.54,0.5152,0.1045,9,81,90
0,1,19,0.16,0.1515,0.2537,1,98,99
1,5,4,0.46,0.4545,0.1343,0,2,2
1,7,15,0.78,0.6818,0.0896,94,223,317
0,12,17,0.4,0.4091,0.1642,14,417,431
0,9,8,0.62,0.5455,0.2239,17,270,287
0,5,14,0.62,0.6212,0.0,42,134,176
0,6,22,0.66,0.6061,0.2239,38,114,152
0,5,17,0.58,0.5455,0.2239,47,227,274
1,5,11,0.58,0.5455,0.2239,77,202,279
1,2,15,0.42,0.4242,0.0896,17,149,166
0,11,19,0.46,0.4545,0.3881,3,108,111
1,7,13,0.8,0.7424,0.1045,64,176,240
1,1,19,0.22,0.19699999999999998,0.3881,5,251,256
0,2,2,0.1,0.1364,0.0896,0,3,3
1,7,17,0.76,0.6818,0.2239,91,704,795
0,2,6,0.24,0.2879,0.0,2,1,3
0,11,22,0.58,0.5455,0.3582,17,96,113
1,4,20,0.5,0.4848,0.2985,5,34,39
1,11,20,0.36,0.3485,0.1343,20,235,255
0,2,18,0.34,0.2879,0.5522,7,175,182
0,11,6,0.26,0.2879,0.0896,5,11,16
0,12,1,0.22,0.2121,0.2239,0,15,15
0,2,4,0.22,0.2273,0.1343,0,8,8
1,6,10,0.52,0.5,0.2985,58,118,176
0,1,8,0.14,0.1515,0.1343,1,22,23
1,1,11,0.3,0.3182,0.1045,11,100,111
0,9,19,0.7,0.6667,0.1343,147,148,295
1,5,3,0.46,0.4545,0.2239,0,3,3
0,6,6,0.6,0.5758,0.1343,1,25,26
0,8,16,0.9,0.7879,0.0,34,197,231
1,7,17,0.86,0.7879,0.2836,101,598,699
0,9,16,0.72,0.6667,0.2985,180,303,483
1,12,8,0.24,0.2424,0.1343,11,133,144
0,5,12,0.6,0.6212,0.2537,69,186,255
0,8,16,0.9,0.7727,0.2836,58,216,274
0,7,21,0.78,0.7576,0.2836,31,165,196
1,8,14,0.78,0.6970000000000001,0.1045,109,229,338
0,3,13,0.38,0.3939,0.0,88,115,203
1,3,9,0.3,0.2727,0.3284,12,252,264
1,12,4,0.42,0.4242,0.1642,3,5,8
0,4,8,0.38,0.3939,0.5821,9,148,157
1,2,20,0.32,0.3333,0.1343,5,211,216
0,4,9,0.34,0.3485,0.1045,27,71,98
1,6,21,0.62,0.5909,0.1045,35,238,273
0,12,23,0.34,0.3485,0.1045,3,42,45
1,12,6,0.26,0.2424,0.2537,2,112,114
0,4,17,0.52,0.5,0.2836,63,280,343
1,12,17,0.38,0.3939,0.1343,77,268,345
0,10,23,0.46,0.4545,0.0896,9,50,59
1,9,14,0.66,0.6212,0.1343,225,410,635
1,9,14,0.7,0.6515,0.2985,113,299,412
1,10,3,0.36,0.3788,0.0,0,7,7
0,1,0,0.2,0.19699999999999998,0.19399999999999998,4,13,17
1,3,15,0.44,0.4394,0.19399999999999998,139,282,421
0,1,22,0.16,0.1818,0.1045,1,28,29
0,3,8,0.28,0.2727,0.2537,15,244,259
0,1,19,0.32,0.2879,0.4478,1,29,30
1,12,21,0.42,0.4242,0.1343,6,114,120
0,1,18,0.2,0.2273,0.0896,7,116,123
1,4,20,0.44,0.4394,0.2537,26,254,280
1,6,17,0.9,0.8182,0.0,80,611,691
1,12,13,0.42,0.4242,0.19399999999999998,30,183,213
0,8,3,0.56,0.5303,0.0,2,4,6
0,7,2,0.6,0.5909,0.1343,10,48,58
1,4,2,0.36,0.3333,0.3582,11,25,36
1,12,6,0.36,0.3788,0.0,3,150,153
0,10,19,0.54,0.5152,0.3881,52,181,233
0,2,15,0.4,0.4091,0.3881,5,58,63
0,2,9,0.42,0.4242,0.2836,15,127,142
1,7,1,0.7,0.6515,0.19399999999999998,2,26,28
1,5,15,0.76,0.7121,0.19399999999999998,106,360,466
1,12,1,0.32,0.3485,0.0,1,19,20
0,4,21,0.5,0.4848,0.1343,8,114,122
1,2,8,0.08,0.0758,0.2537,0,26,26
1,10,11,0.54,0.5152,0.3582,61,252,313
0,8,12,0.76,0.7273,0.1045,70,173,243
0,12,5,0.22,0.2121,0.2239,0,12,12
1,3,23,0.48,0.4697,0.19399999999999998,12,85,97
0,11,20,0.46,0.4545,0.2239,6,121,127
1,1,20,0.4,0.4091,0.1343,8,216,224
0,3,9,0.4,0.4091,0.4179,8,36,44
1,4,22,0.42,0.4242,0.19399999999999998,17,106,123
0,5,10,0.54,0.5152,0.2537,31,73,104
1,3,11,0.42,0.4242,0.2985,33,128,161
1,5,13,0.72,0.6515,0.0,77,273,350
0,5,15,0.74,0.6818,0.4179,59,129,188
1,6,16,0.66,0.5909,0.2836,30,209,239
1,10,22,0.44,0.4394,0.1343,45,140,185
1,8,16,0.82,0.7576,0.2537,143,278,421
1,4,21,0.56,0.5303,0.2985,37,260,297
0,5,9,0.62,0.6061,0.1045,59,130,189
1,2,7,0.24,0.2576,0.1045,5,276,281
0,10,4,0.3,0.2727,0.4179,0,1,1
1,12,0,0.3,0.3182,0.0896,9,108,117
1,11,5,0.34,0.3333,0.1343,1,39,40
1,9,10,0.64,0.6212,0.2985,172,323,495
1,8,22,0.6,0.5606,0.0,25,136,161
0,9,20,0.7,0.6667,0.1642,99,120,219
0,8,21,0.68,0.6364,0.3881,40,127,167
0,12,20,0.3,0.3182,0.0896,14,42,56
1,12,22,0.3,0.303,0.1642,3,16,19
1,4,11,0.52,0.5,0.1343,42,177,219
1,2,14,0.4,0.4091,0.2239,13,111,124
1,5,21,0.56,0.5303,0.19399999999999998,55,148,203
1,9,6,0.52,0.5,0.19399999999999998,11,24,35
0,5,0,0.64,0.5758,0.2239,32,51,83
1,4,11,0.52,0.5,0.19399999999999998,207,357,564
1,8,13,0.88,0.7576,0.3284,97,271,368
0,6,7,0.66,0.6061,0.2239,21,247,268
0,6,7,0.64,0.5909,0.1343,12,45,57
1,9,16,0.64,0.6061,0.2537,74,379,453
1,3,6,0.46,0.4545,0.19399999999999998,5,108,113
1,4,7,0.34,0.3333,0.19399999999999998,15,339,354
1,4,16,0.66,0.6212,0.19399999999999998,151,429,580
0,10,5,0.22,0.2727,0.0,0,18,18
1,5,10,0.64,0.6061,0.1343,47,138,185
1,12,7,0.22,0.2121,0.2985,8,381,389
1,5,3,0.56,0.5303,0.1045,1,5,6
0,5,21,0.52,0.5,0.1343,28,128,156
1,6,14,0.88,0.7727,0.2537,114,295,409
0,11,14,0.48,0.4697,0.19399999999999998,14,121,135
0,8,1,0.7,0.6364,0.1343,9,17,26
1,4,4,0.38,0.3939,0.2537,0,2,2
1,3,16,0.72,0.6515,0.3881,53,312,365
0,6,3,0.62,0.5909,0.1343,0,2,2
0,5,9,0.5,0.4848,0.2836,41,131,172
0,2,14,0.34,0.303,0.3284,57,154,211
1,7,12,0.88,0.7576,0.1045,111,220,331
0,4,15,0.66,0.6212,0.3284,46,117,163
0,1,5,0.24,0.2576,0.0896,0,1,1
0,9,1,0.62,0.5909,0.1045,4,28,32
0,3,18,0.68,0.6364,0.1642,84,247,331
0,9,18,0.76,0.7273,0.19399999999999998,187,169,356
1,6,19,0.78,0.6818,0.3284,101,542,643
0,9,17,0.58,0.5455,0.1343,85,483,568
0,6,1,0.7,0.6515,0.2239,5,18,23
0,9,4,0.6,0.5,0.0,6,7,13
1,2,13,0.4,0.4091,0.3582,34,171,205
1,12,4,0.4,0.4091,0.1045,1,11,12
1,3,14,0.5,0.4848,0.3582,63,175,238
0,9,6,0.54,0.5152,0.19399999999999998,5,112,117
1,5,15,0.76,0.6667,0.2985,81,209,290
0,11,16,0.46,0.4545,0.2239,84,263,347
1,1,15,0.18,0.1515,0.3284,9,81,90
0,6,15,0.64,0.6212,0.1642,42,136,178
1,6,8,0.68,0.6364,0.2239,34,133,167
0,10,6,0.44,0.4394,0.0,5,39,44
1,9,11,0.76,0.7121,0.1343,81,215,296
1,11,19,0.3,0.303,0.1642,28,368,396
0,10,4,0.5,0.4848,0.4627,2,6,8
1,4,3,0.36,0.3333,0.2537,7,21,28
0,10,16,0.64,0.6212,0.3284,37,245,282
0,9,3,0.6,0.5152,0.0,20,39,59
0,11,10,0.4,0.4091,0.0,6,46,52
1,11,15,0.36,0.3333,0.2836,32,228,260
1,5,23,0.62,0.5758,0.1343,31,65,96
1,3,21,0.3,0.2879,0.2239,16,94,110
1,6,5,0.64,0.5758,0.19399999999999998,1,11,12
0,12,5,0.32,0.2879,0.3582,0,9,9
0,9,0,0.62,0.5455,0.0,6,23,29
0,3,13,0.34,0.3333,0.1343,14,94,108
1,5,9,0.66,0.6212,0.2537,47,264,311
1,6,22,0.62,0.6212,0.2985,29,209,238
0,2,15,0.66,0.6212,0.3284,55,117,172
0,9,20,0.66,0.6212,0.19399999999999998,31,241,272
0,12,5,0.46,0.4545,0.1642,0,3,3
1,3,11,0.4,0.4091,0.2537,106,217,323
1,10,14,0.56,0.5303,0.0,335,376,711
0,3,20,0.36,0.3636,0.0896,13,119,132
0,4,8,0.4,0.4091,0.4925,19,346,365
0,10,14,0.54,0.5152,0.1642,17,80,97
0,10,19,0.46,0.4545,0.3582,20,278,298
1,6,6,0.5,0.4848,0.19399999999999998,5,31,36
1,2,20,0.34,0.3182,0.2537,4,223,227
1,10,2,0.4,0.4091,0.0896,8,58,66
0,4,15,0.54,0.5152,0.4478,50,112,162
0,2,2,0.08,0.0758,0.2836,1,2,3
1,11,19,0.34,0.3485,0.0896,30,331,361
0,6,1,0.66,0.6061,0.0,3,20,23
0,7,16,0.84,0.7576,0.2836,128,244,372
0,8,1,0.66,0.6212,0.1045,4,8,12
0,7,1,0.8,0.7879,0.0,7,17,24
1,12,6,0.24,0.19699999999999998,0.4179,1,7,8
0,12,4,0.38,0.3939,0.2836,0,2,2
0,4,19,0.42,0.4242,0.19399999999999998,51,93,144
0,10,16,0.6,0.5909,0.1642,63,257,320
1,3,14,0.58,0.5455,0.2239,37,174,211
0,6,7,0.7,0.6667,0.0,23,288,311
1,2,2,0.26,0.2879,0.0896,7,9,16
1,7,14,0.9,0.8788,0.2537,62,151,213
1,12,7,0.38,0.3939,0.2537,3,291,294
1,6,15,0.78,0.6818,0.4627,65,168,233
0,10,7,0.46,0.4545,0.0,12,102,114
1,6,18,0.64,0.6212,0.19399999999999998,203,310,513
1,12,19,0.24,0.2273,0.19399999999999998,15,113,128
1,9,12,0.66,0.6212,0.3582,287,419,706
0,10,13,0.24,0.19699999999999998,0.5224,0,30,30
0,9,15,0.68,0.6364,0.0896,35,170,205
1,3,6,0.4,0.4091,0.1045,2,9,11
0,6,23,0.72,0.6970000000000001,0.2239,14,91,105
1,2,18,0.34,0.3333,0.1343,8,345,353
0,12,18,0.24,0.2273,0.19399999999999998,12,151,163
0,5,13,0.68,0.6364,0.0,61,153,214
1,3,14,0.72,0.6515,0.1045,81,177,258
0,1,7,0.12,0.1515,0.1343,0,72,72
0,2,0,0.32,0.3485,0.0,1,8,9
0,12,22,0.22,0.2727,0.0,7,36,43
0,6,18,0.72,0.6818,0.4179,57,483,540
0,1,12,0.3,0.3333,0.0,7,77,84
1,7,3,0.7,0.6667,0.1642,3,9,12
0,12,3,0.16,0.1818,0.1343,2,17,19
1,7,1,0.7,0.6667,0.0,4,15,19
1,4,17,0.64,0.6212,0.2836,122,697,819
1,2,0,0.26,0.303,0.0,0,14,14
1,4,2,0.56,0.5303,0.1045,1,3,4
0,4,17,0.6,0.6061,0.0,50,338,388
0,4,4,0.38,0.3939,0.0896,0,3,3
0,10,3,0.4,0.4091,0.0896,1,3,4
0,7,13,0.86,0.8182,0.2537,22,119,141
1,4,1,0.42,0.4242,0.0,8,17,25
1,4,3,0.44,0.4394,0.1642,0,3,3
1,7,1,0.7,0.6667,0.1343,0,15,15
1,3,16,0.62,0.6212,0.0896,51,170,221
0,1,2,0.2,0.2121,0.1642,0,2,2
0,1,7,0.16,0.1364,0.2836,1,71,72
0,8,8,0.62,0.6212,0.1343,34,459,493
1,4,16,0.6,0.5909,0.3284,49,327,376
0,7,5,0.66,0.5909,0.0896,3,24,27
0,2,21,0.38,0.3939,0.1642,8,61,69
0,3,21,0.62,0.6212,0.1045,22,91,113
0,9,19,0.68,0.6364,0.1642,55,341,396
1,8,6,0.56,0.5303,0.1045,5,164,169
1,8,23,0.68,0.6364,0.0,25,85,110
1,3,23,0.52,0.5,0.0,10,80,90
0,5,14,0.74,0.6818,0.1642,47,121,168
1,10,10,0.58,0.5455,0.19399999999999998,26,198,224
1,7,15,0.76,0.7121,0.1343,29,115,144
0,4,20,0.44,0.4394,0.2537,7,119,126
1,11,16,0.36,0.3333,0.3284,108,292,400
1,5,23,0.56,0.5303,0.2836,35,114,149
1,12,2,0.26,0.2727,0.1343,0,11,11
1,7,13,0.86,0.8333,0.2985,53,189,242
1,5,19,0.64,0.6212,0.19399999999999998,86,451,537
1,7,23,0.6,0.5455,0.0,32,117,149
1,9,5,0.56,0.5303,0.0,1,37,38
0,4,19,0.36,0.3333,0.2985,12,148,160
1,1,10,0.22,0.2121,0.2836,3,82,85
0,1,10,0.1,0.1364,0.0,6,34,40
1,11,7,0.22,0.2424,0.1045,2,19,21
1,12,23,0.4,0.4091,0.0,18,144,162
1,7,14,0.92,0.8333,0.3284,87,154,241
0,5,7,0.62,0.5909,0.1343,29,284,313
0,12,4,0.38,0.3939,0.1343,0,3,3
1,5,14,0.62,0.5909,0.2537,43,128,171
1,1,9,0.28,0.2576,0.3284,6,196,202
1,3,19,0.46,0.4545,0.1642,34,191,225
0,7,7,0.7,0.6515,0.0896,22,248,270
0,6,21,0.74,0.7121,0.1642,31,216,247
0,7,11,0.82,0.7121,0.0,49,102,151
0,1,14,0.22,0.2273,0.1642,2,26,28
0,5,18,0.56,0.5303,0.2537,60,177,237
1,5,21,0.62,0.6061,0.0896,31,210,241
1,5,23,0.6,0.5758,0.3582,32,54,86
1,10,23,0.58,0.5455,0.0896,12,111,123
0,4,21,0.62,0.5909,0.2836,33,162,195
1,7,6,0.64,0.5758,0.2537,6,86,92
0,11,6,0.52,0.5,0.2836,1,88,89
0,10,5,0.38,0.3939,0.1343,0,24,24
1,11,18,0.32,0.2879,0.3582,17,448,465
1,11,18,0.36,0.3485,0.2239,31,206,237
0,11,14,0.62,0.6212,0.4478,47,138,185
1,9,0,0.46,0.4545,0.1642,8,56,64
1,1,3,0.3,0.3333,0.0,11,41,52
0,1,12,0.36,0.3333,0.2985,20,73,93
1,4,20,0.42,0.4242,0.1045,8,252,260
1,10,23,0.54,0.5152,0.1045,9,102,111
1,2,12,0.14,0.0758,0.6418,7,133,140
0,2,9,0.24,0.2121,0.2836,2,122,124
1,4,0,0.32,0.3333,0.1343,0,13,13
1,12,21,0.34,0.3182,0.2239,4,164,168
0,4,10,0.4,0.4091,0.19399999999999998,4,42,46
1,1,2,0.22,0.2273,0.1642,2,3,5
0,8,18,0.72,0.6970000000000001,0.2537,96,215,311
0,6,9,0.62,0.6212,0.19399999999999998,19,174,193
1,3,8,0.44,0.4394,0.0,34,628,662
1,4,12,0.44,0.4394,0.0,66,210,276
0,3,8,0.24,0.2273,0.2537,7,185,192
1,11,9,0.28,0.2727,0.19399999999999998,13,309,322
1,4,7,0.5,0.4848,0.1045,16,30,46
1,8,9,0.7,0.6515,0.0,57,339,396
1,8,22,0.72,0.6818,0.3284,44,148,192
1,8,18,0.86,0.7879,0.3284,169,321,490
0,6,9,0.76,0.6970000000000001,0.0,37,176,213
0,8,1,0.6,0.5909,0.1045,5,15,20
0,1,19,0.24,0.2576,0.1045,2,110,112
1,5,23,0.62,0.5909,0.1045,14,91,105
1,12,21,0.24,0.2424,0.1343,7,184,191
0,8,3,0.6,0.5606,0.19399999999999998,1,6,7
1,10,3,0.42,0.4242,0.1045,0,2,2
1,12,15,0.36,0.3485,0.1343,40,240,280
1,11,14,0.42,0.4242,0.1045,47,204,251
0,3,18,0.36,0.3333,0.2985,18,207,225
0,6,22,0.64,0.5909,0.2239,36,94,130
0,9,12,0.74,0.6818,0.2239,56,156,212
1,8,4,0.64,0.5909,0.1343,1,3,4
1,12,12,0.4,0.4091,0.2239,122,364,486
1,11,21,0.38,0.3939,0.1343,29,238,267
0,12,14,0.4,0.4091,0.2239,20,130,150
0,12,15,0.44,0.4394,0.0,15,139,154
0,12,11,0.3,0.303,0.1642,43,42,85
1,1,16,0.24,0.2424,0.1642,14,108,122
1,3,22,0.52,0.5,0.1642,41,156,197
0,3,3,0.24,0.2576,0.0896,1,2,3
1,6,10,0.72,0.6818,0.1642,52,95,147
1,8,18,0.7,0.6667,0.2985,107,193,300
0,9,19,0.66,0.6061,0.2537,57,315,372
0,11,2,0.38,0.3939,0.0,0,5,5
1,11,22,0.26,0.2273,0.3284,15,120,135
1,1,4,0.02,0.0455,0.19399999999999998,0,2,2
1,11,23,0.32,0.3485,0.0,7,50,57
1,6,21,0.82,0.7727,0.19399999999999998,55,256,311
0,9,4,0.6,0.5606,0.0896,2,2,4
0,6,17,0.72,0.6818,0.3582,74,495,569
0,6,6,0.6,0.5758,0.1343,10,116,126
1,8,20,0.66,0.5909,0.4179,31,129,160
0,11,12,0.46,0.4545,0.2239,62,88,150
1,1,2,0.4,0.4091,0.3582,1,13,14
1,3,22,0.56,0.5303,0.3284,12,141,153
0,7,17,0.74,0.6667,0.2537,104,483,587
1,2,23,0.24,0.2424,0.1343,4,38,42
1,6,9,0.58,0.5455,0.4179,30,298,328
1,11,19,0.48,0.4697,0.1343,69,208,277
1,3,17,0.62,0.6212,0.4179,87,557,644
0,12,7,0.32,0.3182,0.19399999999999998,6,252,258
0,2,5,0.14,0.2121,0.0,0,3,3
1,3,1,0.2,0.19699999999999998,0.2537,0,6,6
1,4,17,0.54,0.5152,0.1642,49,565,614
1,12,20,0.26,0.2576,0.1642,8,81,89
1,6,12,0.68,0.6364,0.4179,93,241,334
0,12,0,0.2,0.2273,0.0896,4,16,20
1,12,5,0.38,0.3939,0.1045,0,27,27
0,11,11,0.38,0.3939,0.2836,102,213,315
1,5,7,0.42,0.4242,0.2537,6,345,351
0,10,8,0.44,0.4394,0.19399999999999998,28,71,99
1,3,2,0.26,0.2424,0.2537,12,30,42
1,4,0,0.36,0.3333,0.2537,8,59,67
1,12,9,0.28,0.2879,0.1343,13,272,285
0,11,23,0.48,0.4697,0.2537,3,36,39
1,6,0,0.56,0.5303,0.2537,12,28,40
0,10,17,0.56,0.5303,0.1343,80,540,620
0,8,23,0.62,0.6212,0.2537,19,45,64
0,10,9,0.28,0.2576,0.3582,1,19,20
0,12,8,0.42,0.4242,0.0896,10,422,432
0,12,0,0.3,0.3182,0.1045,19,64,83
1,10,9,0.54,0.5152,0.1343,56,347,403
0,11,18,0.38,0.3939,0.1343,36,172,208
1,8,12,0.86,0.8182,0.2985,95,243,338
1,7,20,0.84,0.7424,0.1343,88,244,332
0,12,5,0.2,0.2273,0.1045,0,10,10
1,4,6,0.34,0.3333,0.1343,1,6,7
1,8,22,0.72,0.6970000000000001,0.1045,43,181,224
0,11,9,0.48,0.4697,0.3284,29,204,233
0,12,0,0.5,0.4848,0.3284,12,60,72
1,10,14,0.44,0.4394,0.0,71,243,314
1,2,12,0.3,0.303,0.1343,49,256,305
0,7,4,0.66,0.6212,0.0896,0,5,5
1,5,12,0.62,0.6061,0.3284,60,203,263
1,12,0,0.36,0.3636,0.0896,0,20,20
0,12,22,0.36,0.3788,0.0,3,104,107
1,1,16,0.24,0.2273,0.2239,28,178,206
0,9,6,0.6,0.5,0.1343,7,94,101
0,4,8,0.62,0.6061,0.4627,22,374,396
1,11,12,0.4,0.4091,0.2836,101,341,442
0,10,23,0.48,0.4697,0.0,52,90,142
0,10,16,0.56,0.5303,0.1642,21,180,201
0,5,21,0.52,0.5,0.0896,32,95,127
0,4,3,0.64,0.5909,0.3881,2,1,3
0,10,13,0.64,0.6212,0.19399999999999998,48,171,219
0,7,12,0.76,0.7273,0.2836,49,164,213
1,4,1,0.32,0.303,0.2239,2,7,9
0,11,17,0.4,0.4091,0.19399999999999998,61,171,232
1,6,4,0.6,0.5455,0.1642,0,4,4
1,3,12,0.54,0.5152,0.0,58,171,229
1,2,2,0.22,0.2273,0.1343,0,2,2
1,6,2,0.66,0.6061,0.1642,1,5,6
1,12,2,0.42,0.4242,0.1642,1,9,10
0,2,22,0.24,0.2879,0.0,1,60,61
0,1,7,0.2,0.2121,0.1343,8,76,84
1,4,13,0.46,0.4545,0.2985,97,184,281
0,7,4,0.66,0.6212,0.1642,1,4,5
0,9,4,0.62,0.5455,0.0896,0,3,3
0,1,12,0.2,0.1818,0.3284,0,3,3
0,5,17,0.72,0.6515,0.1642,191,253,444
1,10,13,0.7,0.6667,0.1045,55,224,279
1,10,17,0.68,0.6364,0.0,67,871,938
1,1,11,0.3,0.303,0.1343,55,241,296
0,5,2,0.52,0.5,0.1343,13,37,50
1,3,20,0.6,0.6212,0.1642,45,306,351
1,5,21,0.64,0.6212,0.19399999999999998,48,121,169
1,1,23,0.44,0.4394,0.2985,4,25,29
1,5,9,0.64,0.5758,0.1343,52,288,340
1,6,19,0.58,0.5455,0.2537,68,445,513
1,2,19,0.32,0.3182,0.1642,4,254,258
1,7,2,0.72,0.6970000000000001,0.0896,21,69,90
1,8,12,0.8,0.7424,0.0,63,217,280
0,5,2,0.5,0.4848,0.2836,0,4,4
1,5,6,0.52,0.5,0.1642,6,15,21
1,5,17,0.72,0.6667,0.1343,87,617,704
0,2,13,0.3,0.2727,0.3284,28,75,103
0,3,15,0.36,0.3788,0.0,35,77,112
0,8,0,0.66,0.6061,0.19399999999999998,29,104,133
0,10,22,0.56,0.5303,0.19399999999999998,27,120,147
0,4,22,0.4,0.4091,0.1045,7,29,36
0,4,16,0.62,0.5909,0.2537,42,228,270
1,10,21,0.4,0.4091,0.19399999999999998,47,157,204
0,10,9,0.52,0.5,0.0896,29,198,227
1,11,16,0.4,0.4091,0.1343,37,368,405
0,9,19,0.62,0.5455,0.0,30,253,283
1,1,14,0.22,0.2273,0.19399999999999998,13,48,61
0,1,21,0.32,0.303,0.2239,6,51,57
1,6,11,0.64,0.6212,0.2537,199,312,511
0,11,19,0.36,0.3485,0.2239,19,192,211
1,7,17,0.66,0.5909,0.4179,95,620,715
1,1,14,0.32,0.3333,0.1343,15,100,115
1,3,14,0.36,0.3333,0.3582,106,226,332
0,9,6,0.56,0.5303,0.0,1,108,109
0,9,4,0.6,0.5606,0.1343,3,6,9
0,7,16,0.96,0.8636,0.3881,35,198,233
1,5,12,0.56,0.5303,0.2836,53,132,185
0,10,7,0.54,0.5152,0.1343,5,76,81
0,10,10,0.5,0.4848,0.2537,26,102,128
1,2,16,0.3,0.2879,0.2239,35,261,296
0,3,5,0.16,0.1818,0.1343,0,7,7
1,6,15,0.6,0.5909,0.19399999999999998,61,176,237
0,8,4,0.6,0.5606,0.1343,1,4,5
1,11,17,0.42,0.4242,0.1343,61,593,654
1,4,5,0.3,0.2879,0.2239,0,21,21
1,10,7,0.58,0.5455,0.3284,15,461,476
0,10,5,0.42,0.4242,0.1642,1,6,7
0,5,15,0.7,0.6515,0.4478,37,117,154
1,4,2,0.48,0.4697,0.4179,4,18,22
1,9,22,0.62,0.5758,0.2985,2,45,47
0,1,21,0.16,0.1364,0.3284,0,57,57
1,6,0,0.58,0.5455,0.1343,25,112,137
1,9,20,0.6,0.6212,0.1045,57,267,324
0,1,11,0.22,0.2576,0.0896,2,57,59
1,8,19,0.76,0.7273,0.19399999999999998,94,533,627
1,11,23,0.42,0.4242,0.4478,20,47,67
1,7,18,0.74,0.6970000000000001,0.1642,173,342,515
1,3,21,0.56,0.5303,0.0,38,239,277
0,10,1,0.22,0.2121,0.2537,9,34,43
0,11,18,0.56,0.5303,0.2239,20,396,416
0,1,22,0.22,0.2576,0.0896,1,34,35
1,9,9,0.7,0.6667,0.0,88,144,232
1,8,22,0.76,0.7273,0.2836,104,165,269
0,10,8,0.44,0.4394,0.0,25,383,408
0,3,10,0.4,0.4091,0.1642,0,17,17
1,1,19,0.18,0.1515,0.3881,0,85,85
1,11,9,0.36,0.3788,0.0,94,179,273
0,11,16,0.34,0.3333,0.1343,19,190,209
1,11,22,0.28,0.3182,0.0,6,167,173
1,3,17,0.6,0.5909,0.0896,113,616,729
1,7,12,0.9,0.8182,0.0,80,174,254
1,7,6,0.72,0.6667,0.0,3,130,133
1,7,13,0.86,0.7879,0.1045,171,309,480
0,2,11,0.14,0.1515,0.1642,1,40,41
0,7,6,0.7,0.6667,0.1045,11,91,102
0,7,14,0.86,0.8333,0.2239,44,83,127
0,6,5,0.62,0.5758,0.1642,1,21,22
0,11,7,0.26,0.2727,0.1045,9,276,285
0,11,7,0.46,0.4545,0.0,7,130,137
1,2,18,0.42,0.4242,0.0,11,289,300
1,11,23,0.32,0.3333,0.0896,20,142,162
0,4,14,0.36,0.3182,0.4925,9,67,76
1,1,22,0.34,0.3333,0.19399999999999998,0,49,49
0,3,9,0.22,0.19699999999999998,0.4179,8,116,124
0,4,1,0.62,0.6212,0.4179,10,5,15
0,4,23,0.4,0.4091,0.1343,5,57,62
1,11,4,0.2,0.2273,0.0896,0,7,7
0,3,6,0.2,0.2576,0.0,3,42,45
1,6,7,0.62,0.5606,0.2537,16,287,303
0,8,6,0.66,0.5909,0.2836,4,10,14
1,7,10,0.66,0.6212,0.0,114,265,379
1,8,16,0.64,0.5758,0.2836,57,116,173
1,3,18,0.66,0.6212,0.2836,98,648,746
1,7,7,0.66,0.6061,0.1045,26,471,497
0,1,8,0.22,0.2121,0.2836,2,247,249
0,11,1,0.32,0.3333,0.0896,5,24,29
1,2,17,0.3,0.2879,0.19399999999999998,13,54,67
0,6,2,0.64,0.5758,0.0896,0,7,7
0,6,20,0.66,0.6061,0.1642,62,144,206
0,5,11,0.52,0.5,0.1343,72,207,279
1,6,1,0.64,0.6212,0.0896,34,89,123
1,1,16,0.2,0.1818,0.2985,5,113,118
1,4,15,0.5,0.4848,0.4179,60,176,236
1,11,18,0.38,0.3939,0.3284,32,490,522
0,2,21,0.14,0.1515,0.1642,0,83,83
1,10,0,0.52,0.5,0.2985,20,97,117
1,9,6,0.44,0.4394,0.0,9,161,170
0,5,3,0.64,0.5606,0.19399999999999998,10,8,18
0,6,9,0.7,0.6515,0.19399999999999998,28,196,224
1,3,23,0.44,0.4394,0.0,22,104,126
1,3,14,0.7,0.6364,0.3284,61,163,224
0,2,12,0.24,0.19699999999999998,0.4925,2,63,65
0,7,15,0.88,0.8182,0.19399999999999998,48,110,158
1,9,8,0.6,0.5909,0.2985,21,197,218
1,2,20,0.32,0.3182,0.1642,9,79,88
0,5,2,0.68,0.6364,0.2239,6,12,18
0,12,9,0.36,0.3333,0.3881,8,235,243
0,8,16,0.82,0.7121,0.0,68,266,334
1,11,11,0.42,0.4242,0.0896,45,160,205
1,9,1,0.62,0.5606,0.1045,10,19,29
1,1,8,0.26,0.2727,0.1045,14,498,512
0,6,9,0.62,0.6212,0.3582,35,189,224
1,10,15,0.72,0.6667,0.2836,77,248,325
0,11,0,0.34,0.3333,0.1642,7,22,29
1,12,3,0.4,0.4091,0.1343,1,3,4
0,2,8,0.16,0.2273,0.0,7,223,230
1,6,12,0.9,0.8182,0.19399999999999998,33,182,215
0,12,20,0.3,0.3182,0.0896,17,110,127
0,6,0,0.66,0.6061,0.1642,7,19,26
0,11,20,0.4,0.4091,0.0,18,191,209
0,9,5,0.52,0.5,0.19399999999999998,3,23,26
1,12,15,0.42,0.4242,0.0,95,352,447
1,11,17,0.26,0.2273,0.3881,29,97,126
0,12,6,0.22,0.2121,0.2836,0,71,71
1,3,12,0.54,0.5152,0.19399999999999998,48,224,272
1,7,8,0.76,0.6970000000000001,0.19399999999999998,20,548,568
1,1,20,0.34,0.3485,0.1045,10,190,200
0,10,0,0.26,0.303,0.0,3,20,23
0,2,5,0.2,0.19699999999999998,0.19399999999999998,0,5,5
1,12,11,0.2,0.1667,0.4627,0,10,10
0,12,19,0.38,0.3939,0.0,6,218,224
0,9,6,0.6,0.5455,0.1045,1,74,75
1,9,4,0.62,0.5606,0.0,1,7,8
1,10,14,0.52,0.5,0.0896,78,270,348
0,2,13,0.22,0.2273,0.1642,10,62,72
1,12,4,0.2,0.2273,0.0896,1,9,10
0,11,17,0.48,0.4697,0.0896,33,465,498
1,6,0,0.56,0.5303,0.1343,31,117,148
0,5,14,0.52,0.5,0.2836,70,120,190
1,6,13,0.86,0.7879,0.1045,48,163,211
1,10,13,0.48,0.4697,0.4179,75,316,391
0,11,13,0.48,0.4697,0.0,177,148,325
1,5,7,0.56,0.5303,0.1343,1,91,92
0,10,12,0.62,0.6212,0.0896,42,159,201
0,7,13,0.82,0.7424,0.1045,67,136,203
0,6,19,0.64,0.5758,0.2537,53,275,328
0,11,23,0.52,0.5,0.1343,5,41,46
0,11,4,0.3,0.3333,0.0,0,4,4
1,4,20,0.46,0.4545,0.1642,48,281,329
0,9,11,0.6,0.5152,0.0,1,9,10
1,3,10,0.4,0.4091,0.0896,44,136,180
0,2,10,0.22,0.2121,0.2537,13,71,84
1,7,8,0.58,0.5455,0.2537,18,94,112
0,1,16,0.16,0.1818,0.19399999999999998,3,83,86
1,6,20,0.6,0.6212,0.3582,71,390,461
1,9,21,0.7,0.6667,0.1642,55,246,301
1,8,4,0.62,0.5909,0.2239,5,8,13
1,5,18,0.68,0.6364,0.1343,76,709,785
0,10,7,0.34,0.3485,0.0896,3,18,21
0,4,8,0.54,0.5152,0.2985,35,386,421
0,4,14,0.74,0.6515,0.4925,47,76,123
0,5,18,0.84,0.8029999999999999,0.19399999999999998,55,362,417
1,4,14,0.52,0.5,0.0,125,223,348
1,11,4,0.28,0.2879,0.1343,0,5,5
0,10,23,0.44,0.4394,0.0896,18,81,99
0,10,1,0.44,0.4394,0.1343,13,64,77
1,3,18,0.6,0.5909,0.0,152,627,779
1,9,18,0.68,0.6364,0.2537,108,744,852
0,12,13,0.3,0.2727,0.3582,9,115,124
0,7,20,0.82,0.7424,0.19399999999999998,57,251,308
0,9,0,0.62,0.5455,0.1343,9,28,37
0,7,8,0.7,0.6364,0.1642,39,453,492
1,11,16,0.38,0.3939,0.2985,28,282,310
0,2,15,0.4,0.4091,0.2985,40,122,162
1,9,12,0.72,0.6970000000000001,0.2239,11,126,137
1,8,7,0.66,0.6061,0.0896,1,178,179
1,7,18,0.82,0.7576,0.1045,69,672,741
1,2,8,0.2,0.19699999999999998,0.2537,2,57,59
0,5,7,0.52,0.5,0.2537,13,138,151
1,3,22,0.36,0.3485,0.1642,23,130,153
1,1,13,0.32,0.3485,0.0,8,57,65
1,12,8,0.26,0.2121,0.6119,0,29,29
0,11,4,0.24,0.2879,0.0,0,6,6
1,1,6,0.34,0.2879,0.5224,0,88,88
0,8,1,0.72,0.6970000000000001,0.19399999999999998,5,12,17
1,8,14,0.76,0.6667,0.2836,242,356,598
1,11,23,0.42,0.4242,0.19399999999999998,16,93,109
1,8,2,0.68,0.6364,0.0,1,7,8
1,4,17,0.8,0.6970000000000001,0.3881,111,601,712
1,6,10,0.7,0.6364,0.2537,34,138,172
1,3,15,0.48,0.4697,0.6119,66,157,223
1,6,6,0.7,0.6667,0.0896,3,147,150
0,11,20,0.38,0.3939,0.2537,8,176,184
0,4,2,0.24,0.2424,0.1343,0,5,5
1,6,5,0.48,0.4697,0.0896,0,34,34
1,11,16,0.36,0.3333,0.2836,35,325,360
0,7,5,0.68,0.6364,0.2537,3,24,27
1,2,6,0.32,0.303,0.2985,2,98,100
1,9,13,0.72,0.6970000000000001,0.0896,263,230,493
0,6,23,0.64,0.6061,0.0896,5,55,60
1,2,16,0.32,0.2727,0.5821,32,163,195
0,1,1,0.16,0.1818,0.1045,0,6,6
0,3,1,0.58,0.5455,0.3582,16,35,51
1,4,3,0.44,0.4394,0.0896,0,3,3
0,7,9,0.84,0.7879,0.1642,30,102,132
0,9,12,0.58,0.5455,0.0896,51,138,189
0,9,17,0.66,0.5909,0.1045,37,77,114
0,3,16,0.38,0.3939,0.1642,12,124,136
1,2,6,0.2,0.2576,0.0,3,83,86
0,8,11,0.72,0.6818,0.0896,45,120,165
0,1,14,0.46,0.4545,0.2836,35,71,106
0,12,6,0.16,0.1818,0.1045,1,63,64
1,3,16,0.48,0.4697,0.4179,51,292,343
0,5,0,0.52,0.5,0.1045,17,21,38
0,9,11,0.62,0.5152,0.1045,1,20,21
0,3,13,0.5,0.4848,0.4627,174,127,301
1,1,6,0.16,0.1667,0.1642,0,1,1
1,5,19,0.58,0.5455,0.3284,83,463,546
1,5,7,0.62,0.5606,0.1642,10,44,54
1,5,3,0.62,0.6061,0.0896,0,8,8
0,12,3,0.32,0.3485,0.0,0,2,2
1,11,13,0.26,0.2576,0.1642,37,158,195
0,5,4,0.5,0.4848,0.0,3,9,12
0,7,18,0.76,0.6818,0.2836,185,243,428
1,1,18,0.46,0.4545,0.4478,12,451,463
0,1,23,0.16,0.19699999999999998,0.0896,1,18,19
1,6,3,0.56,0.5303,0.2537,8,18,26
0,12,4,0.46,0.4545,0.2239,0,7,7
0,11,8,0.48,0.4697,0.1045,7,316,323
1,8,4,0.6,0.5909,0.2239,2,8,10
1,10,6,0.5,0.4848,0.19399999999999998,2,29,31
0,5,19,0.7,0.6515,0.19399999999999998,99,153,252
1,4,2,0.44,0.4394,0.2239,7,25,32
0,10,8,0.4,0.4091,0.3284,9,58,67
1,12,18,0.32,0.3333,0.1045,20,446,466
1,7,20,0.76,0.7121,0.1642,56,347,403
0,8,3,0.66,0.6212,0.1343,9,18,27
1,4,8,0.4,0.4091,0.19399999999999998,19,65,84
1,5,6,0.54,0.5152,0.0,9,33,42
1,12,11,0.32,0.3333,0.1045,74,318,392
1,12,13,0.38,0.3939,0.19399999999999998,67,289,356
1,1,13,0.22,0.2121,0.2985,12,144,156
1,8,5,0.64,0.5758,0.1642,2,27,29
1,12,6,0.24,0.2576,0.0896,3,109,112
1,6,15,0.86,0.7273,0.3284,24,195,219
1,9,1,0.58,0.5455,0.2985,18,106,124
1,1,10,0.22,0.2121,0.2836,1,96,97
0,7,16,0.76,0.6667,0.1343,43,231,274
0,5,17,0.4,0.4091,0.2537,22,388,410
0,1,6,0.18,0.1818,0.19399999999999998,0,5,5
0,9,8,0.46,0.4545,0.2537,27,81,108
1,3,6,0.3,0.2727,0.2985,0,5,5
1,4,17,0.64,0.6061,0.2985,108,673,781
0,1,12,0.24,0.2121,0.2836,29,75,104
0,10,4,0.54,0.5152,0.3881,1,6,7
0,1,14,0.18,0.19699999999999998,0.1343,1,85,86
0,5,2,0.38,0.3939,0.1045,1,15,16
1,6,7,0.64,0.5909,0.1045,25,478,503
1,4,21,0.56,0.5303,0.1343,53,167,220
0,7,14,0.96,0.8636,0.2239,34,114,148
1,9,6,0.5,0.4848,0.0896,6,199,205
0,6,11,0.6,0.5758,0.1045,27,67,94
0,7,0,0.66,0.6212,0.2239,34,91,125
1,3,5,0.44,0.4394,0.1343,2,25,27
0,12,20,0.24,0.2273,0.2239,9,70,79
1,1,19,0.46,0.4545,0.4179,11,297,308
1,2,17,0.54,0.5152,0.1642,49,561,610
1,11,10,0.36,0.3333,0.3881,68,260,328
1,4,10,0.38,0.3939,0.3284,11,57,68
1,1,14,0.26,0.2121,0.5522,10,119,129
1,4,1,0.36,0.3485,0.1343,5,37,42
1,6,6,0.64,0.5758,0.0896,9,156,165
0,11,20,0.48,0.4697,0.1343,26,212,238
1,12,3,0.24,0.2424,0.1642,0,2,2
0,5,18,0.72,0.6970000000000001,0.2836,151,177,328
1,1,7,0.22,0.2121,0.2239,2,183,185
0,4,15,0.34,0.303,0.4179,30,81,111
0,12,15,0.32,0.303,0.2239,15,82,97
0,8,17,0.8,0.7273,0.2985,44,365,409
0,9,18,0.6,0.5,0.0,14,220,234
1,9,22,0.56,0.5303,0.1045,27,189,216
0,11,19,0.54,0.5152,0.2239,4,260,264
1,7,15,0.9,0.8182,0.2836,101,244,345
0,12,12,0.36,0.3333,0.2985,27,146,173
0,10,20,0.46,0.4545,0.3284,34,207,241
0,1,11,0.28,0.303,0.0896,5,47,52
1,10,21,0.42,0.4242,0.1642,42,124,166
1,12,10,0.26,0.2576,0.19399999999999998,28,162,190
1,11,0,0.28,0.3182,0.0,0,32,32
0,1,1,0.16,0.1667,0.1642,0,5,5
0,2,16,0.52,0.5,0.4627,16,102,118
1,10,19,0.52,0.5,0.2239,67,233,300
1,5,15,0.68,0.6212,0.19399999999999998,269,321,590
0,7,11,0.82,0.7727,0.1642,39,86,125
0,4,9,0.5,0.4848,0.1045,37,132,169
1,2,20,0.16,0.1212,0.5522,1,62,63
0,10,19,0.58,0.5455,0.1343,40,334,374
1,3,3,0.26,0.2273,0.3284,0,4,4
1,10,21,0.4,0.4091,0.19399999999999998,12,180,192
0,6,5,0.7,0.6667,0.0,1,19,20
1,6,1,0.64,0.5758,0.2239,3,55,58
0,9,3,0.44,0.4394,0.19399999999999998,11,25,36
1,7,8,0.68,0.6364,0.1642,39,652,691
1,6,5,0.6,0.6212,0.1045,4,15,19
1,12,13,0.32,0.2879,0.4478,23,135,158
0,9,8,0.46,0.4545,0.2537,16,53,69
1,5,10,0.62,0.5909,0.2537,30,144,174
1,12,11,0.26,0.2576,0.1642,16,162,178
1,5,20,0.52,0.5,0.3284,59,315,374
0,11,19,0.4,0.4091,0.0896,46,100,146
0,8,14,0.82,0.7576,0.3284,67,115,182
1,9,19,0.56,0.5303,0.2239,72,539,611
1,6,14,0.58,0.5455,0.19399999999999998,59,160,219
0,10,14,0.52,0.5,0.0,14,52,66
0,10,13,0.66,0.6212,0.0896,225,193,418
0,11,16,0.52,0.5,0.0,40,255,295
0,9,16,0.54,0.5152,0.2537,116,189,305
0,9,21,0.46,0.4545,0.3284,11,134,145
1,4,8,0.42,0.4242,0.1045,26,651,677
1,5,13,0.64,0.6212,0.19399999999999998,293,366,659
0,7,5,0.74,0.6818,0.19399999999999998,4,22,26
1,11,21,0.32,0.303,0.2985,5,121,126
1,3,15,0.5,0.4848,0.2985,201,286,487
0,7,21,0.78,0.7424,0.2985,68,96,164
0,9,9,0.62,0.5909,0.2537,27,198,225
1,9,18,0.52,0.5,0.4478,91,310,401
0,3,13,0.36,0.3333,0.2836,23,74,97
1,11,3,0.26,0.303,0.0,1,0,1
1,10,17,0.64,0.6212,0.19399999999999998,193,346,539
0,1,22,0.06,0.0303,0.3881,1,33,34
1,9,6,0.44,0.4394,0.0896,2,20,22
1,6,15,0.86,0.7424,0.2239,197,290,487
1,2,9,0.2,0.1818,0.3582,12,98,110
1,6,2,0.64,0.5758,0.0,7,54,61
0,2,21,0.28,0.2576,0.3881,7,56,63
0,5,14,0.62,0.6061,0.2239,43,148,191
1,5,13,0.74,0.6818,0.1343,217,307,524
1,12,16,0.34,0.3333,0.19399999999999998,53,137,190
0,6,15,0.74,0.6515,0.4179,180,224,404
1,12,9,0.26,0.2727,0.1045,17,203,220
0,9,10,0.6,0.5455,0.0896,90,203,293
1,7,6,0.64,0.5909,0.0896,6,29,35
0,8,18,0.78,0.6818,0.0896,74,497,571
1,6,11,0.76,0.6818,0.0896,184,315,499
0,10,16,0.58,0.5455,0.2537,64,238,302
1,4,11,0.52,0.5,0.0,46,183,229
